Sherwin	MALE
Brady	MALE
Laurianne	FEMALE
Jocelyn	FEMALE
Simone	MALE
Loretta	FEMALE
Denise	FEMALE
Sebastian	MALE
Nicoline	FEMALE
Hedwig	FEMALE
Mitch	MALE
Lynnell	FEMALE
Renato	MALE
Blair	MALE
Elsinore	FEMALE
Ricard	MALE
Philomena	FEMALE
Lotta	FEMALE
Temp	MALE
Suki	FEMALE
Donny	MALE
Caroleen	FEMALE
Catharine	FEMALE
Constanta	FEMALE
Voltaire	MALE
Micki	FEMALE
Ros	FEMALE
Stefano	MALE
Meredith	MALE
Kerry	MALE
Shalom	MALE
Hermia	FEMALE
Shannen	FEMALE
Gerhard	MALE
Jacklin	FEMALE
Percy	MALE
Ferdie	MALE
Moshe	MALE
Celestine	FEMALE
Roddie	MALE
Perceval	MALE
Maiga	FEMALE
Gerri	MALE
Henderson	MALE
Rosemary	FEMALE
Vikkie	FEMALE
Kalila	FEMALE
Reina	FEMALE
Charleton	MALE
Orelee	FEMALE
Rich	MALE
Saunderson	MALE
Reynolds	MALE
Thibaut	MALE
Rubi	FEMALE
Simonne	FEMALE
Rickard	MALE
Ginnifer	FEMALE
Damara	FEMALE
Elliot	MALE
Tedi	FEMALE
Oliy	FEMALE
Engelbert	MALE
Lulita	FEMALE
Rose	FEMALE
Benson	MALE
Jephthah	MALE
Mignon	FEMALE
Matti	FEMALE
Else	FEMALE
Loreen	FEMALE
Carree	FEMALE
Flin	MALE
Carolan	FEMALE
Katine	FEMALE
Lawrence	MALE
Yolanda	FEMALE
Jonas	MALE
Karrah	FEMALE
Frederick	MALE
Michail	MALE
Allie	MALE
Rutter	MALE
Jarrett	MALE
Scottie	MALE
Jessamyn	FEMALE
Ozzy	MALE
Ailina	FEMALE
Margret	FEMALE
Sonny	MALE
Helen	FEMALE
Delphine	FEMALE
Giffy	MALE
Richardo	MALE
Abdullah	MALE
Felicio	MALE
Lorraine	FEMALE
Zena	FEMALE
Marius	MALE
Violet	FEMALE
Frederica	FEMALE
Kissie	FEMALE
Berkeley	MALE
Ulberto	MALE
Ewan	MALE
Emlyn	FEMALE
Marieann	FEMALE
Tasia	FEMALE
Dora	FEMALE
Dodie	FEMALE
Wendie	FEMALE
Melvin	MALE
Aurore	FEMALE
Pincas	MALE
Jandy	FEMALE
Chandler	MALE
Darren	MALE
Aleece	FEMALE
Robbie	MALE
Julienne	FEMALE
Temple	MALE
Ross	MALE
Nina	FEMALE
Corwin	MALE
Wilt	MALE
Rochella	FEMALE
Sanders	MALE
Demetri	MALE
Troy	MALE
Rufe	MALE
Earle	MALE
Hillary	MALE
Darian	MALE
Tarrance	MALE
Karil	FEMALE
Naomi	FEMALE
Nelli	FEMALE
Raleigh	MALE
Stu	MALE
Ebba	FEMALE
Giacomo	MALE
Alfonzo	MALE
Vida	FEMALE
Celesta	FEMALE
Charmain	FEMALE
Fernande	FEMALE
Agneta	FEMALE
Randi	MALE
Claudetta	FEMALE
Hersch	MALE
Windham	MALE
Wanda	FEMALE
Rutherford	MALE
Jen	FEMALE
Zeke	MALE
August	MALE
Traci	FEMALE
Elwina	FEMALE
Noelani	FEMALE
Kasey	FEMALE
Cornie	FEMALE
Zarla	FEMALE
Bettie	FEMALE
Corrie	MALE
Florida	FEMALE
Lucius	MALE
Hymie	MALE
Elnore	FEMALE
Izak	MALE
Morton	MALE
Roxanna	FEMALE
Laurent	MALE
Abby	MALE
Johny	MALE
Hugo	MALE
Kippy	FEMALE
Dulsea	FEMALE
Fabian	MALE
Joya	FEMALE
Wilburn	MALE
Cynthia	FEMALE
Dimitry	MALE
Jonathon	MALE
Neil	MALE
Terrie	FEMALE
Gilbertina	FEMALE
Worden	MALE
Waine	MALE
Kalle	MALE
Penelopa	FEMALE
Kippie	FEMALE
Bette	FEMALE
Monroe	MALE
Felicity	FEMALE
Rosemarie	FEMALE
Ann	FEMALE
Jean-Christophe	MALE
Cybal	FEMALE
Christofer	MALE
Perl	FEMALE
Northrup	MALE
Charline	FEMALE
Lawton	MALE
Geraldo	MALE
Florance	FEMALE
Jaymee	FEMALE
Hilda	FEMALE
Louis	MALE
Ike	MALE
Cecil	MALE
Hashim	MALE
Prent	MALE
Jean-Lou	MALE
Vergil	MALE
Nana	FEMALE
Silvester	MALE
Georgine	FEMALE
Jolie	FEMALE
June	FEMALE
Lloyd	MALE
Israel	MALE
Philippa	FEMALE
Jessie	MALE
Dario	MALE
Redmond	MALE
Donna	FEMALE
Dulciana	FEMALE
Rinaldo	MALE
Clair	MALE
Maximilien	MALE
Joice	FEMALE
Luther	MALE
Carmel	FEMALE
Ali	MALE
Shara	FEMALE
Marshall	MALE
Aubine	FEMALE
Bard	MALE
Patty	MALE
Parke	MALE
Shannon	MALE
Nissa	FEMALE
Mathias	MALE
Fitzgerald	MALE
Arly	FEMALE
Rodolph	MALE
Flower	FEMALE
Marika	FEMALE
Marcy	FEMALE
Ace	MALE
Magda	FEMALE
Moishe	MALE
Danyette	FEMALE
Donelle	FEMALE
Reyna	FEMALE
Adams	MALE
Suzette	FEMALE
Ronna	FEMALE
Amalle	FEMALE
Brita	FEMALE
Irene	FEMALE
Boyd	MALE
Miran	FEMALE
Konstanze	FEMALE
Zuzana	FEMALE
Mark	MALE
Udale	MALE
Anurag	MALE
Reena	FEMALE
Nanice	FEMALE
Moria	FEMALE
Laurance	MALE
Beulah	FEMALE
Elianore	FEMALE
Brian	MALE
Ernesto	MALE
Anders	MALE
Quinn	MALE
Emilio	MALE
Mei	FEMALE
Donica	FEMALE
Batsheva	FEMALE
Guenna	FEMALE
Roderich	MALE
Sully	MALE
Bartie	MALE
Teresina	FEMALE
Lorene	FEMALE
Eleanora	FEMALE
Kaylil	FEMALE
Jewell	FEMALE
Taite	MALE
Durand	MALE
Quill	MALE
Yolanthe	FEMALE
Koo	FEMALE
Darlene	FEMALE
Dione	FEMALE
Nataline	FEMALE
Marion	MALE
Manfred	MALE
Ninon	FEMALE
Lotty	FEMALE
Gussie	FEMALE
Tuesday	FEMALE
Umberto	MALE
Weber	MALE
Gladys	FEMALE
Roosevelt	MALE
Agathe	FEMALE
Jon	MALE
Marlo	MALE
Sargent	MALE
Marcela	FEMALE
Sax	MALE
Piotr	MALE
Maxim	MALE
Nathaniel	MALE
Thayne	MALE
Wynn	MALE
Agatha	FEMALE
Bruno	MALE
Isabel	FEMALE
Basil	MALE
Guy	MALE
Hamilton	MALE
Morrie	MALE
Leanne	FEMALE
Lockwood	MALE
Jacquie	FEMALE
Nadeen	FEMALE
Wendell	MALE
Isabella	FEMALE
Florrie	FEMALE
Ranee	FEMALE
Brewer	MALE
Con	FEMALE
Myrtle	FEMALE
Veradis	FEMALE
Marv	MALE
Nicholas	MALE
Hadleigh	MALE
Euclid	MALE
Alfie	MALE
Shayne	MALE
Ariella	FEMALE
Marlowe	MALE
Sammie	MALE
Karena	FEMALE
Stephenie	FEMALE
Candi	FEMALE
Gerrilee	FEMALE
Willamina	FEMALE
Olaf	MALE
Gerold	MALE
Serene	FEMALE
Shilpa	FEMALE
Berenice	FEMALE
Jerrold	MALE
Broddie	MALE
Tawnya	FEMALE
Donal	MALE
Muire	FEMALE
Thorpe	MALE
Leilah	FEMALE
Geo	MALE
Ellynn	FEMALE
Rockwell	MALE
Juana	FEMALE
Eleni	FEMALE
Steffie	FEMALE
Brock	MALE
Vern	MALE
Golda	FEMALE
Ezra	MALE
Saunder	MALE
Kimberley	FEMALE
Grier	FEMALE
Steven	MALE
Matt	MALE
Enoch	MALE
Heather	FEMALE
Christian	MALE
Lauraine	FEMALE
Pembroke	MALE
Moya	FEMALE
Duffie	MALE
Sollie	MALE
Urban	MALE
Artur	MALE
Mischa	MALE
Eunice	FEMALE
Marlin	MALE
Athene	FEMALE
Kylie	FEMALE
Remus	MALE
Wilma	FEMALE
Kordula	FEMALE
Lesya	FEMALE
Lemar	MALE
Vernen	MALE
Cindelyn	FEMALE
Kipp	FEMALE
Ami	FEMALE
Brear	FEMALE
Lenard	MALE
Ritchie	MALE
Sullivan	MALE
Marcos	MALE
Christie	MALE
Doyle	MALE
Staford	MALE
Charyl	FEMALE
Ernestine	FEMALE
Munroe	MALE
Thorny	MALE
Pippy	FEMALE
Aleck	MALE
Keenan	MALE
Karoly	FEMALE
Florinda	FEMALE
Gabbie	FEMALE
Case	MALE
Brice	MALE
Tamra	FEMALE
Rourke	MALE
Emmey	FEMALE
Frans	MALE
Fawne	FEMALE
Cally	FEMALE
Annabella	FEMALE
Johnathan	MALE
Chaunce	MALE
Heywood	MALE
Silvan	MALE
Merry	MALE
Vinny	MALE
Kaila	FEMALE
Charisse	FEMALE
Coralie	FEMALE
Jobina	FEMALE
Dougie	MALE
Uri	MALE
Krishna	MALE
Benedikta	FEMALE
Jana	FEMALE
Aldus	MALE
Ivan	MALE
Roderic	MALE
Ceil	FEMALE
Georgianna	FEMALE
Isabelle	FEMALE
Cassy	FEMALE
Mahesh	MALE
Dedie	FEMALE
Maible	FEMALE
Hyacinth	FEMALE
Hakeem	MALE
Granville	MALE
Jesus	MALE
Stirling	MALE
Rayner	MALE
Paloma	FEMALE
Avram	MALE
Juline	FEMALE
Wendi	FEMALE
Andrey	MALE
Thedrick	MALE
Blinni	FEMALE
Sumner	MALE
Averell	MALE
Inez	FEMALE
Keelia	FEMALE
Lukas	MALE
Elwin	MALE
Zedekiah	MALE
Trixie	FEMALE
Ari	MALE
Arlo	MALE
Tarrah	FEMALE
Sibylla	FEMALE
Mauritz	MALE
Perri	FEMALE
Elana	FEMALE
Britte	FEMALE
Annette	FEMALE
Garret	MALE
Biff	MALE
Tomkin	MALE
Glorianna	FEMALE
Elladine	FEMALE
Henrie	MALE
Sidonia	FEMALE
Clem	MALE
Joyan	FEMALE
Orion	MALE
Rolland	MALE
Bartolomei	MALE
Gabriel	MALE
Netty	FEMALE
Morse	MALE
Cosetta	FEMALE
Gabriell	MALE
Taber	MALE
Cecilia	FEMALE
Anna-Diane	FEMALE
Patin	MALE
Obadias	MALE
Stanly	MALE
Denys	FEMALE
Christiana	FEMALE
Eada	FEMALE
Nikos	MALE
Lyndsey	FEMALE
Giralda	FEMALE
Caesar	MALE
Shena	FEMALE
Welch	MALE
Tito	MALE
Ema	FEMALE
Friedrick	MALE
Lela	FEMALE
Aubree	FEMALE
Guinna	FEMALE
Clara	FEMALE
Lyndsay	FEMALE
Noach	MALE
Woochang	MALE
Kym	FEMALE
Worth	MALE
Wilhelmine	FEMALE
Gregorio	MALE
Burgess	MALE
Gustie	FEMALE
Lazaro	MALE
Theodor	MALE
Ashton	MALE
Trevor	MALE
Meggy	FEMALE
Winn	MALE
Demetra	FEMALE
Thatcher	MALE
Anitra	FEMALE
Pammi	FEMALE
Reeva	FEMALE
Tarrant	MALE
Mike	MALE
Giselle	FEMALE
Cybil	FEMALE
Phyllis	FEMALE
Yalonda	FEMALE
Iago	MALE
Mmarianne	FEMALE
Pammie	FEMALE
Quintana	FEMALE
Marlon	MALE
Andreana	FEMALE
Cobb	MALE
Yoshiko	FEMALE
Emera	FEMALE
Jeremias	MALE
Xymenes	MALE
Ryann	FEMALE
Brandea	FEMALE
Gertie	FEMALE
Elwira	FEMALE
Leo	MALE
Rosalynd	FEMALE
Osbert	MALE
Thane	MALE
Emmalynne	FEMALE
Knox	MALE
Terencio	MALE
Chase	MALE
Jerold	MALE
Jess	MALE
Anya	FEMALE
Micheal	MALE
Tremayne	MALE
Joaquin	MALE
Reggis	MALE
Ilene	FEMALE
Ernest	MALE
Maynord	MALE
Carroll	MALE
Maritsa	FEMALE
Sampson	MALE
Burnaby	MALE
Otes	MALE
Roberto	MALE
Mack	MALE
Sebastien	MALE
Hamnet	MALE
Inigo	MALE
Beauregard	MALE
Abbott	MALE
Nico	MALE
Pierre	MALE
Zachery	MALE
Madelle	FEMALE
Jean-Marc	MALE
Briny	FEMALE
Camilla	FEMALE
Gabe	MALE
Jonie	FEMALE
Rutger	MALE
Maud	FEMALE
Rosita	FEMALE
Carleigh	MALE
Aida	FEMALE
Anallese	FEMALE
Stanford	MALE
Theodora	FEMALE
Lia	FEMALE
Zechariah	MALE
Suzy	FEMALE
Beatriz	FEMALE
Reggie	MALE
Fernandina	FEMALE
Felipe	MALE
Diana	FEMALE
Franklyn	MALE
Woodrow	MALE
Emmalynn	FEMALE
Alley	MALE
Blythe	FEMALE
Karol	FEMALE
Ofilia	FEMALE
Christ	MALE
Ruddy	MALE
Sheridan	MALE
Rubin	MALE
Aharon	MALE
Yank	MALE
Bryant	MALE
Lilian	FEMALE
Engelbart	MALE
Mora	FEMALE
Dion	MALE
Clementina	FEMALE
Forrest	MALE
Kelly	MALE
Sonni	FEMALE
Constantia	FEMALE
Heloise	FEMALE
Liam	MALE
Emmalee	FEMALE
Rici	FEMALE
Sophi	FEMALE
Lonny	MALE
Rakel	FEMALE
Clemente	MALE
Gredel	FEMALE
Jefferey	MALE
Brooks	MALE
Johnette	FEMALE
Alicea	FEMALE
Winston	MALE
Erik	MALE
Elene	FEMALE
Georgianne	FEMALE
Corie	FEMALE
Patrick	MALE
Srinivas	MALE
Blake	MALE
Lorianna	FEMALE
Ethyl	FEMALE
Antoine	MALE
Meridith	FEMALE
Zachariah	MALE
Aurie	FEMALE
Gideon	MALE
Horacio	MALE
Pyotr	MALE
Karsten	MALE
Sutherland	MALE
Liuka	FEMALE
Celene	FEMALE
Sandro	MALE
Nelson	MALE
Garrett	MALE
Helise	FEMALE
Rogers	MALE
Martica	FEMALE
Lynn	MALE
Linnell	FEMALE
Rodger	MALE
Vaughan	MALE
Tracie	MALE
Sharlene	FEMALE
Robbert	MALE
Normand	MALE
Madelina	FEMALE
Cletus	MALE
Washington	MALE
Sherlocke	MALE
Tanner	MALE
Iain	MALE
Lynett	FEMALE
Shelba	FEMALE
Myrna	FEMALE
Francesco	MALE
Meghann	FEMALE
Dolly	FEMALE
Cacilia	FEMALE
Amalea	FEMALE
Hagen	MALE
Jewelle	FEMALE
Maxie	MALE
Darla	FEMALE
Carlo	MALE
Emmanuel	MALE
Beowulf	MALE
Marcio	MALE
Pierrette	FEMALE
Rube	MALE
Franklin	MALE
Orelle	FEMALE
Crystal	FEMALE
Reuven	MALE
Sim	MALE
Felicle	FEMALE
Cora	FEMALE
Berthe	FEMALE
Donovan	MALE
Jedediah	MALE
Hamlet	MALE
Sharline	FEMALE
Giordano	MALE
Ingrid	FEMALE
Chiquita	FEMALE
Cathyleen	FEMALE
Darelle	FEMALE
Gabriello	MALE
Arnold	MALE
Orrin	MALE
Jillayne	FEMALE
Munmro	MALE
Etti	FEMALE
Joellen	FEMALE
Herbie	MALE
Rosalinda	FEMALE
Milissent	FEMALE
Olivia	FEMALE
Trenna	FEMALE
Cherise	FEMALE
Claude	MALE
Andre	MALE
Benjamin	MALE
Carrissa	FEMALE
Kathlin	FEMALE
Clarisse	FEMALE
Antonina	FEMALE
Floyd	MALE
Taffy	FEMALE
Beret	FEMALE
Malvina	FEMALE
Sean	MALE
Raynard	MALE
Wit	MALE
Kristian	MALE
Christalle	FEMALE
Belva	FEMALE
Cherida	FEMALE
Alphonse	MALE
Cynthie	FEMALE
Jo	MALE
Iggie	MALE
Torrin	MALE
Love	FEMALE
Bobbie	MALE
Ole	MALE
Stanleigh	MALE
Reinhard	MALE
Merill	MALE
Estella	FEMALE
Walden	MALE
Chelsey	FEMALE
Freemon	MALE
Veriee	FEMALE
Justine	FEMALE
Cassi	FEMALE
Ilka	FEMALE
Idelle	FEMALE
Creighton	MALE
Reynold	MALE
Ximenes	MALE
Terence	MALE
Rosanna	FEMALE
Kellsie	FEMALE
Fulvia	FEMALE
Evy	FEMALE
Stormy	FEMALE
Damita	FEMALE
Reba	FEMALE
Alana	FEMALE
Karola	FEMALE
Isadore	MALE
Barnabe	MALE
Kay	FEMALE
Natalee	FEMALE
Hamlen	MALE
Greer	FEMALE
Arabelle	FEMALE
Peg	FEMALE
Florette	FEMALE
Moses	MALE
Ansell	MALE
Quincy	MALE
Tobie	MALE
Gilligan	FEMALE
Win	MALE
Pattie	MALE
Luke	MALE
Dorella	FEMALE
Fons	MALE
Dew	FEMALE
Augustine	MALE
Hetty	FEMALE
Hercule	MALE
April	FEMALE
Eugenie	FEMALE
Ahmed	MALE
Arliene	FEMALE
Orson	MALE
Dionis	MALE
Dari	FEMALE
Linda	FEMALE
Guido	MALE
Selby	MALE
Sutton	MALE
Neddy	MALE
Roobbie	FEMALE
Sybila	FEMALE
Tiff	FEMALE
Eydie	FEMALE
Charlie	MALE
Wye	MALE
Clay	MALE
Emogene	FEMALE
Juergen	MALE
Charmaine	FEMALE
Royce	MALE
Horatia	FEMALE
Lynea	FEMALE
Tammi	FEMALE
Sofia	FEMALE
Jean-Pierre	MALE
Windy	FEMALE
Quigly	MALE
Rennie	FEMALE
Martyn	MALE
Oleg	MALE
Elora	FEMALE
Annabelle	FEMALE
Emmery	MALE
Westbrook	MALE
Say	MALE
Katleen	FEMALE
Whitby	MALE
Jakob	MALE
Chloris	FEMALE
Vladimir	MALE
Eduard	MALE
Romola	FEMALE
Gus	MALE
Hillery	MALE
Adam	MALE
Clarine	FEMALE
Fabrice	FEMALE
Jasmina	FEMALE
Immanuel	MALE
Antonio	MALE
Elizabet	FEMALE
Hortensia	FEMALE
Cheri	FEMALE
Leslie	MALE
Bebe	FEMALE
Ed	MALE
Calida	FEMALE
Aubrette	FEMALE
Sherri	FEMALE
Oralle	FEMALE
Isidora	FEMALE
Burta	FEMALE
Yardley	MALE
Che	MALE
Jane	FEMALE
Emlynn	FEMALE
Townie	MALE
Dick	MALE
Teodorico	MALE
Rochester	MALE
Perry	MALE
Husain	MALE
Roddy	MALE
Lita	FEMALE
Ruthanne	FEMALE
Conni	FEMALE
Forbes	MALE
Maddy	MALE
Leticia	FEMALE
Jerome	MALE
Henka	FEMALE
Shari	FEMALE
Fabio	MALE
Vinnie	MALE
Nananne	FEMALE
Hamil	MALE
Latashia	FEMALE
Lorita	FEMALE
Natalina	FEMALE
Henriette	FEMALE
Laurel	FEMALE
Fanny	FEMALE
Yancey	MALE
Kizzee	FEMALE
Roseline	FEMALE
Rozina	FEMALE
Marketa	FEMALE
Emilee	FEMALE
Enrique	MALE
Zahara	FEMALE
Corine	FEMALE
Wilhelm	MALE
Bearnard	MALE
Eli	MALE
Sabina	FEMALE
Lorrie	MALE
Renaud	MALE
Dwain	MALE
Bernardo	MALE
Charita	FEMALE
Karita	FEMALE
Christina	FEMALE
Emory	MALE
Mikhail	MALE
Melony	FEMALE
Artie	MALE
Hasty	MALE
Cheston	MALE
Hinda	FEMALE
Stephanus	MALE
Bevvy	FEMALE
Arther	MALE
Kelcey	FEMALE
Kynthia	FEMALE
Verge	MALE
Torr	MALE
Brinkley	MALE
Constantinos	MALE
Amata	FEMALE
Waring	MALE
Wyn	MALE
Katuscha	FEMALE
Jemmie	FEMALE
Novelia	FEMALE
Ashley	MALE
Elijah	MALE
Arvy	MALE
Tomas	MALE
Yvette	FEMALE
Menard	MALE
Colbert	MALE
Gilles	MALE
Jamie	MALE
Darrel	MALE
Queada	FEMALE
Tandie	FEMALE
Thacher	MALE
Hildegaard	FEMALE
Rudiger	MALE
Coral	FEMALE
Harriot	FEMALE
Chastity	FEMALE
Annadiana	FEMALE
Charles	MALE
Felita	FEMALE
Niels	MALE
Eldon	MALE
Prudy	FEMALE
Gwenny	FEMALE
Em	FEMALE
Kirby	MALE
Arleyne	FEMALE
Slim	MALE
Gomer	MALE
Miguel	MALE
Kitty	FEMALE
Brook	MALE
Murphy	MALE
Berrie	FEMALE
Hermon	MALE
Fairfax	MALE
Ariela	FEMALE
Dannye	FEMALE
Thaddeus	MALE
Eimile	FEMALE
Marlane	FEMALE
Amber	FEMALE
Larissa	FEMALE
Delly	FEMALE
Ronald	MALE
Luis	MALE
Rufus	MALE
Lind	MALE
Astrix	FEMALE
Clint	MALE
Valdemar	MALE
Johnathon	MALE
Welby	MALE
Stavros	MALE
Viviyan	FEMALE
Dasha	FEMALE
Clayborne	MALE
Lynsey	FEMALE
Kyrstin	FEMALE
Andrej	MALE
Trula	FEMALE
Daniel	MALE
Ermina	FEMALE
Gloriana	FEMALE
Steffi	FEMALE
Dewitt	MALE
Courtenay	FEMALE
Ivor	MALE
Teriann	FEMALE
Reece	MALE
Tye	MALE
Teddie	MALE
Caroline	FEMALE
Peria	FEMALE
Gershom	MALE
Eleonora	FEMALE
Park	MALE
Xylina	FEMALE
Melinda	FEMALE
Upton	MALE
Izzy	MALE
Bertram	MALE
Lisha	FEMALE
Rosabelle	FEMALE
Sarita	FEMALE
Leann	FEMALE
Rudolfo	MALE
Warden	MALE
Marysa	FEMALE
Welbie	MALE
Stevie	MALE
Bart	MALE
Barret	MALE
Prescott	MALE
Laurence	MALE
Stafford	MALE
Aleksandrs	MALE
Isaac	MALE
Garfield	MALE
Caril	FEMALE
Arvind	MALE
Trent	MALE
Avis	FEMALE
Bathsheba	FEMALE
Debora	FEMALE
Angela	FEMALE
Hartwell	MALE
Maureen	FEMALE
Jamey	MALE
Karisa	FEMALE
Kincaid	MALE
Chrysler	FEMALE
Pierce	MALE
Rheta	FEMALE
Baron	MALE
Matteo	MALE
Adel	FEMALE
Linet	FEMALE
Harvard	MALE
Rhodie	FEMALE
Griff	MALE
Kenny	MALE
Woodie	MALE
Tan	MALE
Stinky	MALE
Inesita	FEMALE
Bogart	MALE
Otto	MALE
Gwyn	FEMALE
Christof	MALE
Geri	MALE
Ursula	FEMALE
Elizabeth	FEMALE
Gwenora	FEMALE
Eustacia	FEMALE
Valenka	FEMALE
Charlton	MALE
Jobyna	FEMALE
Zak	MALE
Dorine	FEMALE
Debbie	FEMALE
Katrina	FEMALE
Gerti	FEMALE
Cyrillus	MALE
Sabra	FEMALE
Flinn	MALE
Dmitri	MALE
Radcliffe	MALE
Jud	MALE
Lynne	FEMALE
Kristy	FEMALE
Wyatt	MALE
Maryangelyn	FEMALE
Tana	FEMALE
Skippie	MALE
Raquel	FEMALE
Darien	MALE
Monty	MALE
Lurlene	FEMALE
Shelly	FEMALE
Havivah	FEMALE
Elfie	FEMALE
Petronia	FEMALE
Odella	FEMALE
Joline	FEMALE
Fara	FEMALE
Reid	MALE
Manda	FEMALE
Morris	MALE
Nicholle	FEMALE
Mallory	FEMALE
Elvin	MALE
Alden	MALE
Clarisa	FEMALE
Caterina	FEMALE
Calley	FEMALE
Jereme	MALE
Florella	FEMALE
Alec	MALE
Cati	FEMALE
Elden	MALE
Tiebold	MALE
Jourdan	FEMALE
Zacherie	MALE
Pincus	MALE
Emelia	FEMALE
Kittie	FEMALE
Joao	MALE
Tobe	MALE
Eden	FEMALE
Rolph	MALE
Paten	MALE
Tamar	FEMALE
Katharyn	FEMALE
Pippa	FEMALE
Eben	MALE
Sheelagh	FEMALE
Oswell	MALE
Nesta	FEMALE
Emelita	FEMALE
Fletcher	MALE
Marven	MALE
Ned	MALE
Rodrick	MALE
Sven	MALE
Alasdair	MALE
Lamar	MALE
Bab	FEMALE
Yigal	MALE
Tiffie	FEMALE
Matthieu	MALE
Barton	MALE
Forrester	MALE
Charlotte	FEMALE
Er	MALE
Christa	FEMALE
Ignace	MALE
Wilson	MALE
Binni	FEMALE
Bret	MALE
Katherine	FEMALE
Leif	MALE
Federica	FEMALE
Rab	MALE
Milton	MALE
Halli	FEMALE
Gerty	FEMALE
Shaun	MALE
Delilah	FEMALE
Brit	FEMALE
Billie	MALE
Siegfried	MALE
Michal	MALE
Katti	FEMALE
Cicily	FEMALE
Christorpher	MALE
Fidela	FEMALE
Filide	FEMALE
Kass	FEMALE
Kelsy	FEMALE
Stevana	FEMALE
Louise	FEMALE
Shaughn	MALE
Len	MALE
Catie	FEMALE
Missy	FEMALE
Quillan	MALE
Guenevere	FEMALE
Nils	MALE
Gunter	MALE
Aube	MALE
Angy	FEMALE
Niall	MALE
Amery	MALE
Abbey	MALE
Greg	MALE
Vilhelmina	FEMALE
Bryce	MALE
Tre	MALE
Finley	MALE
Jessa	FEMALE
Standford	MALE
Chrisy	MALE
Melany	FEMALE
Cate	FEMALE
Danie	MALE
Dacy	FEMALE
Tybalt	MALE
Urbano	MALE
Annadiane	FEMALE
Hewet	MALE
Adair	MALE
Jose	MALE
Ronda	FEMALE
Carola	FEMALE
Harmon	MALE
Aveline	FEMALE
Renell	FEMALE
Westleigh	MALE
Noell	FEMALE
Claudio	MALE
Effie	FEMALE
Dorolice	FEMALE
Avery	MALE
Elga	FEMALE
Nester	MALE
Jolyn	FEMALE
Claus	MALE
Misti	FEMALE
Joey	MALE
Cyrus	MALE
Georgiamay	FEMALE
Janos	MALE
Silvana	FEMALE
Ulick	MALE
Galen	MALE
Shay	MALE
Randolf	MALE
Denis	MALE
Bertha	FEMALE
Diahann	FEMALE
Deryl	MALE
Loleta	FEMALE
Valery	FEMALE
Esta	FEMALE
Thalia	FEMALE
Pierson	MALE
Debby	FEMALE
Urbain	MALE
Bucky	MALE
Muffin	MALE
Honor	FEMALE
Daryle	MALE
Seana	FEMALE
Lacie	FEMALE
Robinia	FEMALE
Georgeta	FEMALE
Roselia	FEMALE
Quinton	MALE
Arlene	FEMALE
Ephrayim	MALE
Deni	FEMALE
Amadeus	MALE
Agnella	FEMALE
Garnette	FEMALE
Deirdre	FEMALE
Lelia	FEMALE
Merrily	FEMALE
Sherie	FEMALE
Madelyn	FEMALE
Bjorn	MALE
Ortensia	FEMALE
Camille	FEMALE
Jeremiah	MALE
Anatollo	MALE
Barnard	MALE
Fredrika	FEMALE
Tanny	MALE
Normie	MALE
Dinny	FEMALE
Jobye	FEMALE
Rolfe	MALE
Brea	FEMALE
Fay	FEMALE
Inglebert	MALE
Benton	MALE
Fidelity	FEMALE
Abraham	MALE
Oliver	MALE
Lissa	FEMALE
Lanita	FEMALE
Shannan	MALE
Carlina	FEMALE
Pennie	MALE
Eolande	FEMALE
Russell	MALE
Town	MALE
Gardener	MALE
Glen	MALE
Spence	MALE
Dea	FEMALE
Kassandra	FEMALE
Izaak	MALE
Rajeev	MALE
Wilbur	MALE
Konrad	MALE
Lishe	FEMALE
Abe	MALE
Pier	FEMALE
Petrina	FEMALE
Dwight	MALE
Celinka	FEMALE
Glori	FEMALE
Lizabeth	FEMALE
Sella	FEMALE
Mindy	FEMALE
Tommi	FEMALE
Linell	FEMALE
Errol	MALE
Farica	FEMALE
Mitra	FEMALE
Leoline	FEMALE
Kaleena	FEMALE
Blisse	FEMALE
Brenda	FEMALE
Eudora	FEMALE
Alexi	FEMALE
Debra	FEMALE
Kenneth	MALE
Tracy	MALE
Winfred	MALE
Danika	FEMALE
Vernon	MALE
Herrmann	MALE
Malynda	FEMALE
Tamera	FEMALE
Jasmin	FEMALE
Beverlie	FEMALE
Tibold	MALE
Jill	FEMALE
Marco	MALE
Jerri	MALE
Caspar	MALE
Valida	FEMALE
Kristel	FEMALE
Rebeka	FEMALE
Mohan	MALE
Raynor	MALE
Fernanda	FEMALE
Odille	FEMALE
Shlomo	MALE
Jake	MALE
Wilek	MALE
Madelene	FEMALE
Haywood	MALE
John-David	MALE
Clifford	MALE
Clemence	FEMALE
Waleed	MALE
Ianthe	FEMALE
Rollo	MALE
Jaimie	FEMALE
Ted	MALE
Francois	MALE
Skipton	MALE
Kalil	MALE
Dorolisa	FEMALE
Angel	MALE
Betsy	FEMALE
Harley	MALE
Dudley	MALE
Janifer	FEMALE
Andreas	MALE
Ginnie	FEMALE
Devon	MALE
Hans	MALE
Herb	MALE
Morry	MALE
Fleming	MALE
Allina	FEMALE
Marnie	FEMALE
Darcie	FEMALE
Garth	MALE
Anton	MALE
Gusta	FEMALE
Lefty	MALE
Calypso	FEMALE
Mikael	MALE
Jenna	FEMALE
Sinclair	MALE
Bendite	FEMALE
Darya	FEMALE
Aili	FEMALE
Filipe	MALE
Roice	MALE
Sheffy	MALE
Rae	FEMALE
Maridel	FEMALE
Tull	MALE
Cyrill	MALE
Flossy	FEMALE
Imogen	FEMALE
Sherill	FEMALE
Hendrick	MALE
Zaria	FEMALE
Andri	MALE
Giacinta	FEMALE
Kenyon	MALE
Jeth	MALE
Maximilian	MALE
Joelie	FEMALE
Way	MALE
Honoria	FEMALE
Honey	FEMALE
Bruce	MALE
Sallyanne	FEMALE
Alysia	FEMALE
Gregor	MALE
Clemmie	MALE
Wenona	FEMALE
Arlie	FEMALE
Rupert	MALE
Carie	FEMALE
Joselyn	FEMALE
Kary	FEMALE
Gretchen	MALE
Jany	FEMALE
Renado	MALE
Fredrick	MALE
Desiri	FEMALE
Vale	MALE
Kingsly	MALE
Clementia	FEMALE
Hirsch	MALE
Mercie	FEMALE
Patrizia	FEMALE
Electra	FEMALE
John	MALE
Anson	MALE
Zebadiah	MALE
Cecile	FEMALE
Murdoch	MALE
Mavra	FEMALE
Baxter	MALE
Petronilla	FEMALE
Bonnee	FEMALE
Ingelbert	MALE
Kayla	FEMALE
Shandra	FEMALE
Zelig	MALE
Sher	FEMALE
Carlene	FEMALE
Holli	FEMALE
Dana	MALE
French	MALE
Roderick	MALE
Vivia	FEMALE
Shoshana	FEMALE
Lou	MALE
Karyl	FEMALE
Meira	FEMALE
Ricky	MALE
Kassie	FEMALE
Blanche	FEMALE
Ivette	FEMALE
Correna	FEMALE
Laurene	FEMALE
Waylan	MALE
Krista	FEMALE
Harmony	FEMALE
Gardiner	MALE
Dorene	FEMALE
Giorgio	MALE
Caron	FEMALE
Antoinette	FEMALE
Darb	FEMALE
Opaline	FEMALE
Rivalee	FEMALE
Jessica	FEMALE
Sigfrid	MALE
Garey	MALE
Kellyann	FEMALE
Claire	MALE
Cherilyn	FEMALE
Tisha	FEMALE
Talya	FEMALE
Marylynne	FEMALE
Jehanna	FEMALE
Lori	FEMALE
Shayla	FEMALE
Moore	MALE
Nona	FEMALE
Arne	MALE
Mart	MALE
Faunie	FEMALE
Blondie	FEMALE
Ernesta	FEMALE
Alyss	FEMALE
Austine	FEMALE
Derrin	MALE
Darcy	MALE
Elton	MALE
Annabel	FEMALE
Charmane	FEMALE
Maurene	FEMALE
Edee	FEMALE
Thibaud	MALE
Goober	MALE
Hayward	MALE
Alanah	FEMALE
Kin	MALE
Phillipp	MALE
Carlin	MALE
Dionysus	MALE
Herminia	FEMALE
Nevins	MALE
Adger	MALE
Arleen	FEMALE
Jaquelin	FEMALE
Ez	MALE
Judson	MALE
Gavrielle	FEMALE
Aprilette	FEMALE
Berke	MALE
Cathrin	FEMALE
Bryon	MALE
Ignacio	MALE
Aphrodite	FEMALE
Lindsay	MALE
Frannie	FEMALE
Emmy	MALE
Aron	MALE
Theadora	FEMALE
Ferd	MALE
Josiah	MALE
Jacki	FEMALE
Gavra	FEMALE
Kimmie	FEMALE
Tamas	MALE
Marietta	MALE
Wayland	MALE
Christi	FEMALE
Yacov	MALE
Melessa	FEMALE
Ambur	FEMALE
Herta	FEMALE
Henrik	MALE
Bernhard	MALE
Ramsey	MALE
Noland	MALE
Carolyne	FEMALE
Connie	MALE
Hew	MALE
Orin	MALE
Janeczka	FEMALE
Stepha	FEMALE
Darell	FEMALE
Annnora	FEMALE
France	FEMALE
Reggy	MALE
Damian	MALE
Teddy	MALE
Skippy	MALE
Olimpia	FEMALE
Tina	FEMALE
Rudie	MALE
Elyn	FEMALE
Tessie	FEMALE
Titos	MALE
Davita	FEMALE
Yaakov	MALE
Ewart	MALE
Allissa	FEMALE
Margery	FEMALE
Towny	MALE
Mariana	FEMALE
Geoffrey	MALE
Phillipe	MALE
Leonore	FEMALE
Woodman	MALE
Karna	FEMALE
Greggory	MALE
Herold	MALE
Myron	MALE
Ruperto	MALE
Tudor	MALE
Analiese	FEMALE
Thurstan	MALE
Marilee	FEMALE
Arie	MALE
Karyn	FEMALE
Tobit	MALE
Caressa	FEMALE
Milo	MALE
Kalindi	FEMALE
Rawley	MALE
Ulrike	FEMALE
Marabel	FEMALE
Jenny	FEMALE
Kristos	MALE
Hannie	FEMALE
Ursala	FEMALE
Lanny	MALE
Christabella	FEMALE
Udall	MALE
Dani	MALE
Sanderson	MALE
Berkley	MALE
Mignonne	FEMALE
Barthel	MALE
Brant	MALE
Salmon	MALE
Alayne	FEMALE
Lorenzo	MALE
Courtney	MALE
Melita	FEMALE
Ken	MALE
Lynelle	FEMALE
Andromache	FEMALE
Giavani	MALE
Anissa	FEMALE
Mercedes	FEMALE
Rory	MALE
Horst	MALE
Genevra	FEMALE
Mairead	FEMALE
Aeriel	FEMALE
Davin	MALE
Ian	MALE
Skipp	MALE
Carmelle	FEMALE
Nevile	MALE
Walton	MALE
Sparky	MALE
Vladamir	MALE
Merell	MALE
Warren	MALE
Mari	FEMALE
Annecorinne	FEMALE
Lizbeth	FEMALE
Karlen	FEMALE
Luce	MALE
Wilfred	MALE
Marga	FEMALE
Tammie	MALE
Alanna	FEMALE
Mirilla	FEMALE
Donnie	MALE
Yolane	FEMALE
Aram	MALE
Lilias	FEMALE
Englebert	MALE
Philbert	MALE
Zary	MALE
Berty	FEMALE
Carlen	FEMALE
Aurelie	FEMALE
Frazier	MALE
Nat	MALE
Bonita	FEMALE
Garfinkel	MALE
Norman	MALE
Sawyer	MALE
Virginie	FEMALE
Minni	FEMALE
Hart	MALE
Willa	FEMALE
Charla	FEMALE
Pasquale	MALE
Marice	FEMALE
Ben	MALE
Darryl	MALE
Ofelia	FEMALE
Darci	FEMALE
Jay	MALE
Zsa Zsa	FEMALE
Tory	FEMALE
Toby	MALE
Von	MALE
Rex	MALE
Hanni	FEMALE
Sam	MALE
Vicki	FEMALE
Wilton	MALE
Jeffry	MALE
Finn	MALE
Del	MALE
Fyodor	MALE
Ninette	FEMALE
Stefania	FEMALE
Werner	MALE
Chen	MALE
Robb	MALE
Graig	MALE
Ibrahim	MALE
Diandra	FEMALE
Orelia	FEMALE
Anjanette	FEMALE
Gregory	MALE
Annamarie	FEMALE
Ricki	MALE
Maggie	FEMALE
Berte	FEMALE
Sheffie	MALE
Imelda	FEMALE
Riki	FEMALE
Daffie	FEMALE
Glennis	FEMALE
Derron	MALE
Mateo	MALE
Daveta	FEMALE
Eileen	FEMALE
Joanie	FEMALE
Maurie	MALE
Jordan	MALE
Tresa	FEMALE
Arlinda	FEMALE
Casey	MALE
Sayer	MALE
Farand	FEMALE
Beatrice	FEMALE
Zeus	MALE
Gratia	FEMALE
Chaddie	MALE
Praneetf	MALE
Skye	MALE
Coriss	FEMALE
Genovera	FEMALE
Marinna	FEMALE
Ana	FEMALE
Rock	MALE
Aurilia	FEMALE
Clarice	FEMALE
Glenn	MALE
Gaby	FEMALE
Jermayne	MALE
Zebulen	MALE
Anstice	FEMALE
Roch	FEMALE
Meta	FEMALE
Adara	FEMALE
Leonardo	MALE
Rickie	MALE
Debbra	FEMALE
Dollie	FEMALE
Karolina	FEMALE
Wells	MALE
Becca	FEMALE
Giancarlo	MALE
Angeline	FEMALE
Gwynne	FEMALE
Cissy	FEMALE
Rahel	FEMALE
Mayor	MALE
Art	MALE
Evvie	FEMALE
Opal	FEMALE
Revkah	FEMALE
Stephi	FEMALE
Vaclav	MALE
Jordain	FEMALE
Desirae	FEMALE
Sharon	FEMALE
Cassandre	FEMALE
Sherye	FEMALE
Melisent	FEMALE
Maureene	FEMALE
Mickey	MALE
Marisa	FEMALE
Davoud	MALE
Loni	FEMALE
Mag	FEMALE
Quigman	MALE
Nahum	MALE
Wyndham	MALE
Neville	MALE
Oprah	FEMALE
Spiros	MALE
Kevan	MALE
Wyatan	MALE
Liliane	FEMALE
Jacinta	FEMALE
Di	FEMALE
Nikki	MALE
Averil	MALE
Hope	FEMALE
Ernie	MALE
Adolphe	MALE
Juliette	FEMALE
Haleigh	MALE
Karon	FEMALE
Jermain	MALE
Meyer	MALE
Ethelred	MALE
Harcourt	MALE
Hillel	MALE
Caritta	FEMALE
Tyson	MALE
Carmita	FEMALE
Yettie	FEMALE
Chas	MALE
Nels	MALE
Eugenia	FEMALE
Dennis	MALE
Barclay	MALE
Francene	FEMALE
Alston	MALE
Ruperta	FEMALE
Wood	MALE
Wallace	MALE
Samuele	MALE
Arabele	FEMALE
Jeni	FEMALE
Florie	FEMALE
Deedee	FEMALE
Jeniffer	FEMALE
Zebedee	MALE
Chevy	MALE
Marguerite	FEMALE
Bronson	MALE
Elaina	FEMALE
Rhody	FEMALE
Randal	MALE
Cris	MALE
Janus	MALE
Shayna	FEMALE
Lucina	FEMALE
Shelby	MALE
Ferguson	MALE
Trev	MALE
Bethena	FEMALE
Neel	MALE
Corey	MALE
Meris	FEMALE
Edwin	MALE
Parnell	MALE
Ardelis	FEMALE
Dory	MALE
Donald	MALE
Judah	MALE
Mirella	FEMALE
Rhianna	FEMALE
Hunt	MALE
Kennedy	MALE
Bernette	FEMALE
Jared	MALE
Joycelin	FEMALE
Ariel	MALE
Odelinda	FEMALE
Jenilee	FEMALE
Chelsea	FEMALE
Kevina	FEMALE
Ann-Mari	FEMALE
Stanwood	MALE
Clyde	MALE
Averyl	FEMALE
Hewitt	MALE
Christy	MALE
Cesya	FEMALE
Shep	MALE
Elmer	MALE
Elias	MALE
Sheffield	MALE
Haley	MALE
Breena	FEMALE
Pauli	FEMALE
Vinni	FEMALE
Patience	FEMALE
Bob	MALE
Sergent	MALE
Julio	MALE
Trevar	MALE
Roscoe	MALE
Guthrey	MALE
Davidson	MALE
Hyman	MALE
Elliott	MALE
Thornie	MALE
Mady	FEMALE
Stephana	FEMALE
Russel	MALE
Janene	FEMALE
Joyann	FEMALE
Rik	MALE
Rosamund	FEMALE
Elwyn	MALE
Bela	MALE
Alfred	MALE
Remington	MALE
Nissie	FEMALE
Sol	MALE
Marsha	FEMALE
Beth	FEMALE
Juditha	FEMALE
Lanie	FEMALE
Glenine	FEMALE
Denice	FEMALE
Tasha	FEMALE
Lacee	FEMALE
Grady	MALE
Sileas	FEMALE
Barbabas	MALE
Dayna	FEMALE
Wald	MALE
Pavla	FEMALE
Linus	MALE
Guillemette	FEMALE
Trey	MALE
Eberhard	MALE
Juli	FEMALE
Fatima	FEMALE
Bennie	MALE
Nariko	FEMALE
Lenka	FEMALE
Zolly	MALE
Peirce	MALE
Lena	FEMALE
Herrick	MALE
Randall	MALE
Desdemona	FEMALE
Locke	MALE
Johann	MALE
Elysee	FEMALE
Verile	FEMALE
Cal	MALE
Alastair	MALE
Jacklyn	FEMALE
Ruthi	FEMALE
Reeba	FEMALE
Rodina	FEMALE
Cobbie	MALE
Hogan	MALE
Amandie	FEMALE
Ware	MALE
Helen-Elizabeth	FEMALE
Kizzie	FEMALE
Rafaelia	FEMALE
Witold	MALE
Cleland	MALE
Griselda	FEMALE
Milt	MALE
Lacy	FEMALE
Sid	MALE
Skip	MALE
Roseann	FEMALE
Hoyt	MALE
Arden	FEMALE
Carol-Jean	FEMALE
Britt	MALE
Melvyn	MALE
Ernst	MALE
Martin	MALE
Lucien	MALE
Peggie	FEMALE
Tova	FEMALE
Benetta	FEMALE
Rog	MALE
Elbert	MALE
Lorilyn	FEMALE
Corry	FEMALE
Tabor	MALE
Jessalyn	FEMALE
Priscilla	FEMALE
Tedra	FEMALE
Alli	FEMALE
Roz	FEMALE
Jean-Francois	MALE
Vanni	FEMALE
Margareta	FEMALE
Lion	MALE
Elly	FEMALE
Orren	MALE
Jimmie	MALE
Freeman	MALE
Theo	MALE
Dorothea	FEMALE
Laurens	MALE
Adnan	MALE
Tawsha	FEMALE
Leta	FEMALE
Siddhartha	MALE
Torry	MALE
Aleks	MALE
Gerhardt	MALE
Deloria	FEMALE
Bartlet	MALE
Sheldon	MALE
Orton	MALE
Doralynn	FEMALE
Wolfy	MALE
Timi	FEMALE
Hollyanne	FEMALE
Tristan	MALE
Tiffani	FEMALE
Ola	FEMALE
Tore	MALE
Elnar	MALE
Annissa	FEMALE
Jenette	FEMALE
Parry	MALE
Tymothy	MALE
Sheppard	MALE
Pacifica	FEMALE
Rahal	FEMALE
Gonzalo	MALE
Shanan	MALE
Letti	FEMALE
Pascale	MALE
Curt	MALE
Gonzales	MALE
Candice	FEMALE
Hellene	FEMALE
Leonie	FEMALE
Rachelle	FEMALE
Theodosia	FEMALE
Ramona	FEMALE
Barnebas	MALE
Patel	MALE
Arlyn	FEMALE
Charlena	FEMALE
Benjie	MALE
Elsbeth	FEMALE
Lucilia	FEMALE
Simonette	FEMALE
Harriet	FEMALE
Jennica	FEMALE
Deonne	FEMALE
Turner	MALE
Andrew	MALE
Iggy	MALE
Jock	MALE
Sallie	FEMALE
Edouard	MALE
Ailey	FEMALE
Bridgett	FEMALE
Kip	MALE
Ricca	FEMALE
Tallie	MALE
Eolanda	FEMALE
Godfree	MALE
Valentine	MALE
Imojean	FEMALE
Joela	FEMALE
Marijo	FEMALE
Jimbo	MALE
Ardis	FEMALE
Casi	FEMALE
Sisely	FEMALE
Son	MALE
Boniface	MALE
Merrielle	FEMALE
Domenic	MALE
Tamara	FEMALE
Winton	MALE
Rosalind	FEMALE
Jefry	MALE
Thatch	MALE
Aileen	FEMALE
Gordan	MALE
Chevalier	MALE
Federico	MALE
Mella	FEMALE
Han	MALE
Mitchael	MALE
Herve	MALE
Esther	FEMALE
Osgood	MALE
Robena	FEMALE
Tiler	MALE
Rosalia	FEMALE
Barry	MALE
Ron	MALE
Fonsie	MALE
Kerstin	FEMALE
Marmaduke	MALE
Norm	MALE
Ronny	MALE
Paddie	MALE
Jacquelin	FEMALE
Dino	MALE
Bertrand	MALE
Suzanne	FEMALE
Cortese	MALE
Dodi	FEMALE
Crawford	MALE
Mathilda	FEMALE
Evonne	FEMALE
Nevil	MALE
Glynda	FEMALE
Chane	MALE
Toddy	MALE
Stefanie	FEMALE
Coleman	MALE
Horatius	MALE
Randa	FEMALE
Welsh	MALE
Timmie	MALE
Kelci	FEMALE
Richard	MALE
Octavius	MALE
Augustus	MALE
Verna	FEMALE
Ronica	FEMALE
Zabrina	FEMALE
Jimmy	MALE
Steffane	FEMALE
Gigi	FEMALE
Kareem	MALE
Merridie	FEMALE
Lila	FEMALE
Ichabod	MALE
Essie	FEMALE
Gasper	MALE
Sophia	FEMALE
Darline	FEMALE
Isador	MALE
Mendel	MALE
Clark	MALE
Riva	FEMALE
Nev	MALE
Mufinella	FEMALE
Billy	MALE
Matthias	MALE
Marys	FEMALE
Xylia	FEMALE
Jennette	FEMALE
Hayden	MALE
Pedro	MALE
Dorthy	FEMALE
Jobi	FEMALE
Jennings	MALE
Seka	FEMALE
Johanna	FEMALE
Rodge	MALE
Fayina	FEMALE
Adrian	MALE
Cherish	FEMALE
Lucille	FEMALE
Nancey	FEMALE
Cookie	FEMALE
Magdalene	FEMALE
Lex	MALE
Betty	FEMALE
Madalyn	FEMALE
Derrol	MALE
Kayle	FEMALE
Darsey	FEMALE
Tabbie	MALE
Theresita	FEMALE
Devonna	FEMALE
Mirelle	FEMALE
Neron	MALE
Lowell	MALE
Kalina	FEMALE
Reube	MALE
Myke	MALE
Cassandra	FEMALE
Wileen	FEMALE
Moira	FEMALE
Tadeas	MALE
Rustie	MALE
Ellsworth	MALE
Dody	FEMALE
Elinore	FEMALE
Karlene	FEMALE
Rosetta	FEMALE
Tildie	FEMALE
Maryrose	FEMALE
Montgomery	MALE
Kimmi	FEMALE
Clemens	MALE
Hubert	MALE
Jarvis	MALE
Marko	MALE
Hadley	MALE
Morlee	MALE
Antonius	MALE
Anselma	FEMALE
Luna	FEMALE
Tymon	MALE
Chadwick	MALE
Saunders	MALE
Charo	FEMALE
Wenda	FEMALE
Pearline	FEMALE
Zacharie	MALE
Angelo	MALE
Durant	MALE
Roni	MALE
Katya	FEMALE
Salvador	MALE
Algernon	MALE
Johnnie	MALE
Anette	FEMALE
Nevin	MALE
Nero	MALE
Prissie	FEMALE
Gleda	FEMALE
Everett	MALE
Kingston	MALE
Dave	MALE
Helena	FEMALE
Ceciley	FEMALE
Gill	MALE
Cissie	FEMALE
Don	MALE
Hans-Peter	MALE
Jessee	MALE
Adele	FEMALE
Kelwin	MALE
Frayda	FEMALE
Codee	FEMALE
Bubba	MALE
Vivi	FEMALE
Ehud	MALE
Lida	FEMALE
Cecily	FEMALE
Jacques	MALE
David	MALE
Darin	MALE
Kathryne	FEMALE
Deana	FEMALE
Jabez	MALE
Marilu	MALE
Gilbert	MALE
Lilla	FEMALE
Dulce	FEMALE
Viviana	FEMALE
Faythe	FEMALE
Jasper	MALE
Rodrique	MALE
Isobel	FEMALE
Anatola	FEMALE
Anna	FEMALE
Marvin	MALE
Godiva	FEMALE
Julie	MALE
Istvan	MALE
Ethelda	FEMALE
Kailey	FEMALE
Amory	MALE
Alameda	FEMALE
Foster	MALE
Corrine	FEMALE
Kermit	MALE
Orbadiah	MALE
Lauri	FEMALE
Mira	FEMALE
Paula	FEMALE
Roxine	FEMALE
Smith	MALE
Haven	MALE
Oberon	MALE
Brandice	FEMALE
Ivonne	FEMALE
Buster	MALE
Easton	MALE
Ruthie	FEMALE
Ilana	FEMALE
Lenna	FEMALE
Tommy	MALE
Mortie	MALE
Charleen	FEMALE
Cynthea	FEMALE
Jim	MALE
Desmond	MALE
Valentin	MALE
Waldo	MALE
Charity	FEMALE
Horace	MALE
Emmalyn	FEMALE
Madella	FEMALE
Sidney	MALE
Wendel	MALE
Fancy	FEMALE
Angelina	FEMALE
Aub	MALE
Gusty	FEMALE
Waite	MALE
Jude	MALE
Yehudi	MALE
Edward	MALE
Luci	FEMALE
Joye	FEMALE
Ric	MALE
Nathanil	MALE
Antonino	MALE
Teodora	FEMALE
Nora	FEMALE
Douglass	MALE
Friedrich	MALE
Eduardo	MALE
Elisha	MALE
Sharron	FEMALE
Corby	MALE
Kora	FEMALE
Carolin	FEMALE
Eba	FEMALE
Rodolfo	MALE
Margie	FEMALE
Conan	MALE
Cornelius	MALE
Web	MALE
Barris	MALE
Curtis	MALE
Kingsley	MALE
Robenia	FEMALE
Penny	MALE
Gerald	MALE
Robert	MALE
Mela	FEMALE
Florri	FEMALE
Wheeler	MALE
Sissie	FEMALE
Vic	MALE
Waylin	MALE
Lola	FEMALE
Pavel	MALE
Bertine	FEMALE
Sinclare	MALE
Shaylah	FEMALE
Roshelle	FEMALE
Bettye	FEMALE
Constance	FEMALE
Jonathan	MALE
Rafe	MALE
Nealson	MALE
Eveleen	FEMALE
Cameron	MALE
Yonina	FEMALE
Archibald	MALE
Talbert	MALE
Heinz	MALE
Dorian	MALE
William	MALE
Benji	MALE
Verene	FEMALE
Clinten	MALE
Leela	FEMALE
Janine	FEMALE
Royal	MALE
Molli	FEMALE
Lisette	FEMALE
Meredeth	MALE
Hester	FEMALE
Lyndsie	FEMALE
Thedric	MALE
Murray	MALE
Johannah	FEMALE
Claribel	FEMALE
Erek	MALE
Schroeder	MALE
Teador	MALE
Fianna	FEMALE
Derk	MALE
Vail	MALE
Malia	FEMALE
Jacquette	FEMALE
Risa	FEMALE
Sonia	FEMALE
Reese	MALE
Osbourn	MALE
Patrice	MALE
Steffen	MALE
Lawson	MALE
Otho	MALE
Cleveland	MALE
Fina	FEMALE
Torrey	MALE
Hilton	MALE
Yuri	MALE
Catherina	FEMALE
Tine	FEMALE
Meir	MALE
Carline	FEMALE
Frederico	MALE
Tannie	MALE
Muhammad	MALE
Warner	MALE
Vikky	FEMALE
Brunella	FEMALE
Carsten	MALE
Reeta	FEMALE
George	MALE
Rebecka	FEMALE
Spencer	MALE
Seth	MALE
Friedric	MALE
Phip	MALE
Abram	MALE
Ardith	FEMALE
Justina	FEMALE
Nelle	FEMALE
Caresa	FEMALE
Demetre	MALE
Si	MALE
Malissia	FEMALE
Karissa	FEMALE
Teodor	MALE
Doris	FEMALE
Dacia	FEMALE
Kirsten	FEMALE
Mac	MALE
Winona	FEMALE
Tomi	FEMALE
Frederic	MALE
Pearl	FEMALE
Agustin	MALE
Terza	FEMALE
Niccolo	MALE
JoAnn	FEMALE
Annice	FEMALE
Dane	MALE
Waylon	MALE
Josephus	MALE
Leanora	FEMALE
Emmit	MALE
Aloysia	FEMALE
Martelle	FEMALE
Vassili	MALE
Nela	FEMALE
Franni	FEMALE
Fulton	MALE
Sybil	FEMALE
Mikako	FEMALE
Alic	MALE
Lucian	MALE
Sidoney	FEMALE
Tomasine	FEMALE
Ellene	FEMALE
Bobby	MALE
Avi	MALE
Luelle	FEMALE
Graeme	MALE
Marie	FEMALE
Chaddy	MALE
Anny	FEMALE
Aldwin	MALE
Amy	FEMALE
Wildon	MALE
Omar	MALE
Shandie	FEMALE
Beau	MALE
Ardelle	FEMALE
Aurel	FEMALE
Jennie	FEMALE
Gilberta	FEMALE
Lorrin	FEMALE
Fanya	FEMALE
Hortense	FEMALE
Gordie	MALE
Augusta	FEMALE
Lorrayne	FEMALE
Duncan	MALE
Cyril	MALE
Shirline	FEMALE
Evan	MALE
Sayers	MALE
Alene	FEMALE
Doroteya	FEMALE
Bride	FEMALE
Gunner	MALE
Harald	MALE
Gayle	MALE
Tucker	MALE
Magna	FEMALE
Brandi	FEMALE
Bernardine	FEMALE
Hector	MALE
Bryn	MALE
Englebart	MALE
Trace	MALE
Lew	MALE
Bertie	MALE
Chicky	FEMALE
Krissy	FEMALE
Andonis	MALE
Zandra	FEMALE
Collette	FEMALE
Gustav	MALE
Christopher	MALE
Sayre	MALE
Wright	MALE
Andrzej	MALE
Pip	MALE
Jannel	FEMALE
Minda	FEMALE
Annie	FEMALE
Nikita	MALE
Marley	FEMALE
Josey	FEMALE
Brandon	MALE
Harlan	MALE
Katie	FEMALE
Edin	FEMALE
Townsend	MALE
Oran	MALE
Sabrina	FEMALE
Bartholemy	MALE
Selinda	FEMALE
Solomon	MALE
Nate	MALE
Christiane	FEMALE
Georgie	MALE
Nigel	MALE
Duke	MALE
Ricardo	MALE
Korella	FEMALE
Gladis	FEMALE
Allah	MALE
Penn	MALE
Randolph	MALE
Trescha	FEMALE
Marty	MALE
Petronille	FEMALE
Marja	FEMALE
Fidelia	FEMALE
Sara	FEMALE
Phyllida	FEMALE
Cybel	FEMALE
Curtice	MALE
Kerri	FEMALE
Van	MALE
Janet	FEMALE
Mayer	MALE
Sandi	FEMALE
Nanon	FEMALE
Nilson	MALE
Major	MALE
Samaria	FEMALE
Leah	FEMALE
Dean	MALE
Margaret	FEMALE
Hedvig	FEMALE
Viki	FEMALE
Billi	FEMALE
Geof	MALE
Susan	FEMALE
Aldrich	MALE
Estrella	FEMALE
Gallagher	MALE
Vick	MALE
Odette	FEMALE
Garwood	MALE
Lolly	FEMALE
Jesselyn	FEMALE
Connor	MALE
Ronnie	MALE
Claybourne	MALE
Bonny	FEMALE
Phil	MALE
Todd	MALE
Gwennie	FEMALE
Chip	MALE
Dela	FEMALE
Emmott	MALE
Zachary	MALE
Florice	FEMALE
Willabella	FEMALE
Gloria	FEMALE
Rhiamon	FEMALE
Goldi	FEMALE
Dot	FEMALE
Ahmad	MALE
Olin	MALE
Ferdinand	MALE
Batholomew	MALE
Philip	MALE
Neely	FEMALE
Silvie	FEMALE
Peta	FEMALE
Clifton	MALE
Wain	MALE
Winonah	FEMALE
Antony	MALE
Dove	FEMALE
Danna	FEMALE
Sal	MALE
Val	MALE
Nancy	FEMALE
Phyllys	FEMALE
Malka	FEMALE
Edie	MALE
Kendall	MALE
Wayne	MALE
Carter	MALE
Timmy	MALE
Audrey	FEMALE
Ivie	FEMALE
Damien	MALE
Flori	FEMALE
Alford	MALE
Florence	FEMALE
Neda	FEMALE
Korrie	FEMALE
Evanne	FEMALE
Josee	FEMALE
Sydelle	FEMALE
Tonia	FEMALE
Lara	FEMALE
Leon	MALE
Greta	FEMALE
Rozele	FEMALE
Dee	FEMALE
Tiana	FEMALE
Adriaens	FEMALE
Mattheus	MALE
Pepito	MALE
Chryste	FEMALE
Marry	FEMALE
Gunther	MALE
Malva	FEMALE
Harvey	MALE
Swen	MALE
Jewel	FEMALE
Paulina	FEMALE
Crissy	FEMALE
Lise	FEMALE
Phineas	MALE
Marget	FEMALE
Cornela	FEMALE
Abelard	MALE
Tully	MALE
Franz	MALE
Raymund	MALE
Hamlin	MALE
Moyna	FEMALE
Judye	FEMALE
Arnoldo	MALE
Vicky	FEMALE
Judi	FEMALE
Jaime	MALE
Janaye	FEMALE
Shalna	FEMALE
Lucas	MALE
Zsazsa	FEMALE
Burl	MALE
Grata	FEMALE
Daniella	FEMALE
Virgina	FEMALE
Nerita	FEMALE
Armando	MALE
Zondra	FEMALE
Cristina	FEMALE
Erin	MALE
Hewe	MALE
Sunny	MALE
Easter	FEMALE
Wallas	MALE
Bamby	FEMALE
Merwin	MALE
Koralle	FEMALE
Klee	MALE
Irena	FEMALE
Phillie	FEMALE
Blondy	FEMALE
Madison	MALE
Tedmund	MALE
Clarke	MALE
Demetria	FEMALE
Elihu	MALE
Gabrielle	FEMALE
Marigold	FEMALE
Nick	MALE
Katrinka	FEMALE
Elysha	FEMALE
Dickie	MALE
Hervey	MALE
Raj	MALE
Micky	MALE
Mitzi	FEMALE
Norah	FEMALE
Chester	MALE
Avraham	MALE
Lee	MALE
Maurise	MALE
Cole	MALE
Alida	FEMALE
Starlene	FEMALE
Edmund	MALE
Glyn	FEMALE
Ardella	FEMALE
Adina	FEMALE
Devin	MALE
Antonella	FEMALE
Tabb	MALE
Colin	MALE
Maggee	FEMALE
Malkah	FEMALE
Catherin	FEMALE
Weston	MALE
Fletch	MALE
Simona	FEMALE
Benjamen	MALE
Torrie	FEMALE
Perle	FEMALE
Garvey	MALE
Marji	FEMALE
Nathalie	FEMALE
Clayton	MALE
Mable	FEMALE
Ash	MALE
Wilmar	MALE
Vita	FEMALE
Anatoly	MALE
Byram	MALE
Julius	MALE
Kory	MALE
Norina	FEMALE
Yevette	FEMALE
Mika	MALE
Mallorie	FEMALE
Xenos	MALE
Samuel	MALE
Barnaby	MALE
Sig	MALE
Lonnie	MALE
Leonelle	FEMALE
Garold	MALE
Cammi	FEMALE
Penrod	MALE
Caroljean	FEMALE
Keene	MALE
Shelton	MALE
Delcina	FEMALE
Kevin	MALE
Lorenza	FEMALE
Godfry	MALE
Jaquenetta	FEMALE
Javier	MALE
Archie	MALE
Les	MALE
Klaus	MALE
Auria	FEMALE
Floria	FEMALE
Riccardo	MALE
Coraline	FEMALE
Joelly	FEMALE
Bernice	FEMALE
Merle	MALE
Verena	FEMALE
Tuck	MALE
Layton	MALE
Susie	FEMALE
Kalman	MALE
Ignacius	MALE
Ram	MALE
Liorah	FEMALE
Dee Dee	FEMALE
Rozelle	FEMALE
Valerye	FEMALE
Loren	MALE
Stew	MALE
Helene	FEMALE
Roseanne	FEMALE
Roland	MALE
Harry	MALE
Erl	MALE
Jaleh	FEMALE
Ardeen	FEMALE
Hannis	FEMALE
Charley	MALE
Salman	MALE
Anita	FEMALE
Angelico	MALE
Serena	FEMALE
Mellissa	FEMALE
Davon	MALE
Roderigo	MALE
Vance	MALE
Ray	MALE
Nealon	MALE
Jervis	MALE
Oralia	FEMALE
Rodney	MALE
Licha	FEMALE
Brewster	MALE
Lebbie	FEMALE
Ingemar	MALE
Forest	MALE
Parwane	FEMALE
Barde	MALE
Chanderjit	MALE
Kalie	FEMALE
Nicki	FEMALE
Cyrille	MALE
Holley	FEMALE
Goldy	FEMALE
Merlina	FEMALE
Jori	FEMALE
Cammie	FEMALE
Hebert	MALE
Derick	MALE
Stillmann	MALE
Arvie	MALE
Geeta	FEMALE
Tiffy	FEMALE
Lane	MALE
Susi	FEMALE
Leonard	MALE
Marilyn	FEMALE
Jaynell	FEMALE
Torie	FEMALE
Goose	MALE
Hill	MALE
Lionello	MALE
Connolly	MALE
Cobby	MALE
Shamit	FEMALE
Lesley	MALE
Missie	FEMALE
Sonya	FEMALE
Ervin	MALE
Marshal	MALE
Matthus	MALE
Eula	FEMALE
Marrissa	FEMALE
Kylila	FEMALE
Therine	FEMALE
Rhett	MALE
Godart	MALE
Jillie	FEMALE
Lissy	FEMALE
Hartley	MALE
Ondrea	FEMALE
Emelda	FEMALE
Vijay	MALE
Florina	FEMALE
Ivy	FEMALE
Rolf	MALE
Nichole	MALE
Emil	MALE
Corrianne	FEMALE
Cliff	MALE
Jammie	FEMALE
Ralph	MALE
Scotti	MALE
Higgins	MALE
Lenny	MALE
Natalia	FEMALE
Ferdinande	FEMALE
Gracia	FEMALE
Harli	FEMALE
Alonzo	MALE
Evita	FEMALE
Pen	MALE
Diego	MALE
Karel	MALE
Garry	MALE
Nancie	FEMALE
Erny	MALE
Clo	FEMALE
Michale	MALE
Saraann	FEMALE
Shepperd	MALE
Erasmus	MALE
Butch	MALE
Ozzie	MALE
Constantin	MALE
Chere	FEMALE
Briggs	MALE
Hayes	MALE
Red	MALE
Rutledge	MALE
Tonnie	MALE
Helge	FEMALE
Wat	MALE
Lucila	FEMALE
Emery	MALE
Paddy	MALE
Doretta	FEMALE
Wilmette	FEMALE
Eugen	MALE
Pepe	MALE
Jody	MALE
Lazar	MALE
Miquela	FEMALE
Witty	MALE
Gertrudis	FEMALE
Saxe	MALE
Constantina	FEMALE
Coletta	FEMALE
Tony	MALE
Cosette	FEMALE
Nikkie	FEMALE
Tirrell	MALE
Leopold	MALE
Karl	MALE
Saundra	MALE
Judith	MALE
Bailie	MALE
Aloise	FEMALE
Nadiya	FEMALE
Ericka	FEMALE
Samson	MALE
Myrlene	FEMALE
Byron	MALE
Chriss	FEMALE
Ebonee	FEMALE
Ulises	MALE
Hermy	MALE
Jeb	MALE
Lana	FEMALE
Jesse	MALE
Maxfield	MALE
Ferinand	MALE
Lura	FEMALE
Milicent	FEMALE
Kati	FEMALE
Salem	MALE
Jacinthe	FEMALE
Dimitrou	MALE
Rand	MALE
Abra	FEMALE
Carolyn	FEMALE
Boyce	MALE
Osmund	MALE
Clarance	MALE
Jordanna	FEMALE
Quintus	MALE
Fayre	FEMALE
Murielle	FEMALE
Marj	FEMALE
Edgar	MALE
Mattias	MALE
Tally	MALE
Doralyn	FEMALE
Kent	MALE
Stern	MALE
Ender	MALE
Slade	MALE
Corenda	FEMALE
Mattie	MALE
Giraldo	MALE
Gregg	MALE
E'Lane	FEMALE
Marilin	FEMALE
Gail	MALE
Rhoda	FEMALE
Aldis	MALE
Melonie	FEMALE
Leland	MALE
Elonore	FEMALE
Apostolos	MALE
Cami	FEMALE
Joann	FEMALE
Mechelle	FEMALE
Uriel	MALE
Lydia	FEMALE
Alberta	FEMALE
Ibby	FEMALE
Ave	MALE
Genevieve	FEMALE
Charlean	FEMALE
Lea	FEMALE
Titus	MALE
Barrett	MALE
Gray	FEMALE
Adriena	FEMALE
Alfonse	MALE
Alethea	FEMALE
Barty	MALE
Adrea	FEMALE
Tailor	MALE
Egbert	MALE
Shane	MALE
Jeannie	FEMALE
Aldric	MALE
Flora	FEMALE
Lincoln	MALE
Eliza	FEMALE
Clarita	FEMALE
Dylan	MALE
Maribelle	FEMALE
Cat	MALE
Dominick	MALE
Tessy	FEMALE
Cooper	MALE
Allsun	FEMALE
Bessie	FEMALE
Catlin	FEMALE
Della	FEMALE
Edith	FEMALE
Magdalen	FEMALE
Ripley	MALE
Marleen	FEMALE
Sada	FEMALE
Tann	MALE
Kara	FEMALE
Velvet	FEMALE
Ingamar	MALE
Reinhold	MALE
Leiah	FEMALE
Ingaborg	FEMALE
Ginny	FEMALE
Orella	FEMALE
Inga	FEMALE
Nathan	MALE
Arabel	FEMALE
Elka	FEMALE
Arthur	MALE
Kiri	FEMALE
Theada	FEMALE
Salvidor	MALE
Winnah	FEMALE
Alf	MALE
Row	FEMALE
Danielle	FEMALE
Isaak	MALE
Ediva	FEMALE
Garvin	MALE
Seymour	MALE
Lorettalorna	FEMALE
Reg	MALE
Cherye	FEMALE
Mickie	MALE
Conway	MALE
Neall	MALE
Cynthy	FEMALE
Debi	FEMALE
Renard	MALE
Abel	MALE
Rivi	FEMALE
Linoel	MALE
Joyce	FEMALE
Lilly	FEMALE
Fitz	MALE
Grover	MALE
Venita	FEMALE
Kayley	FEMALE
Danny	MALE
Amalita	FEMALE
Brietta	FEMALE
Nerte	FEMALE
Robby	FEMALE
Flipper	MALE
Consuelo	FEMALE
Xever	MALE
Grissel	FEMALE
Janeva	FEMALE
Spud	MALE
Rheba	FEMALE
Darleen	FEMALE
Coleen	FEMALE
Darrin	MALE
Kathye	FEMALE
Valene	FEMALE
Pryce	MALE
Cesar	MALE
Deerdre	FEMALE
Esmaria	FEMALE
Orville	MALE
Blakelee	FEMALE
Purcell	MALE
Anselm	MALE
Paulette	FEMALE
Brendan	MALE
Harman	MALE
Xena	FEMALE
Jory	MALE
Howie	MALE
Dimitri	MALE
Lacey	FEMALE
Shirah	FEMALE
Ethelbert	MALE
Ibbie	FEMALE
Marjie	FEMALE
Ulysses	MALE
Nessie	FEMALE
Marline	FEMALE
Melamie	FEMALE
Yale	MALE
Broderick	MALE
Alyson	FEMALE
Chadd	MALE
Odell	MALE
Raul	MALE
Harwell	MALE
Adrianna	FEMALE
Xenia	FEMALE
Geneva	FEMALE
Celine	FEMALE
Calvin	MALE
Paige	MALE
Ilysa	FEMALE
Jan	MALE
Meg	FEMALE
Virgil	MALE
Josepha	FEMALE
Adrien	MALE
Marwin	MALE
Arron	MALE
Harrold	MALE
Wendy	FEMALE
Nicolas	MALE
Appolonia	FEMALE
Amabelle	FEMALE
Flossie	FEMALE
Allys	FEMALE
Tobias	MALE
Chloe	FEMALE
Emilia	FEMALE
Chan	MALE
Evvy	FEMALE
Hattie	FEMALE
Christel	FEMALE
Ede	FEMALE
Abdulkarim	MALE
Dottie	FEMALE
Humphrey	MALE
Irvin	MALE
Joachim	MALE
Demosthenis	MALE
Mortimer	MALE
Rochette	FEMALE
Siouxie	FEMALE
Jeromy	MALE
Archibold	MALE
Wandie	FEMALE
Ragnar	MALE
Henri	MALE
Emile	MALE
Millicent	MALE
Allyce	FEMALE
Celestia	FEMALE
Rayna	FEMALE
Barnett	MALE
Sigmund	MALE
Joseph	MALE
Zacharia	MALE
Eadith	FEMALE
Desaree	FEMALE
Caldwell	MALE
Morten	MALE
Oswald	MALE
Job	MALE
Gwenn	FEMALE
Andromeda	FEMALE
Kimberlyn	FEMALE
Kelsey	MALE
Joelle	FEMALE
Stevena	FEMALE
Petey	MALE
Thor	MALE
Carley	FEMALE
Vivyanne	FEMALE
Clotilda	FEMALE
Brigitta	FEMALE
Tressa	FEMALE
Marillin	FEMALE
Cathlene	FEMALE
Luanna	FEMALE
Kimbra	FEMALE
Sorcha	FEMALE
Deena	FEMALE
Tandi	FEMALE
Ignazio	MALE
Delcine	FEMALE
Sheba	FEMALE
Noemi	FEMALE
Agamemnon	MALE
Nelsen	MALE
Bear	MALE
Lin	MALE
Guthrie	MALE
Kimmo	MALE
Urson	MALE
Opalina	FEMALE
Shepard	MALE
Hannibal	MALE
Bernadene	FEMALE
Larry	MALE
Gwendolen	FEMALE
Markos	MALE
Tamarah	FEMALE
Matthaeus	MALE
Sly	MALE
Carolina	FEMALE
Maison	MALE
Dinah	FEMALE
Fredi	FEMALE
Giffer	MALE
Meier	MALE
Cassandry	FEMALE
Berk	MALE
Nickolas	MALE
Kissee	FEMALE
Goddard	MALE
Bambie	FEMALE
Nan	FEMALE
Benjy	MALE
Maryanne	FEMALE
Louisette	FEMALE
Christyna	FEMALE
Weider	MALE
Andrus	MALE
Taddeus	MALE
Lovell	MALE
Worthy	MALE
Adella	FEMALE
Eddie	MALE
Vaughn	MALE
Roth	MALE
Kellia	FEMALE
Quintin	MALE
Darrick	MALE
Al	MALE
Ferne	FEMALE
Nady	FEMALE
Valerie	FEMALE
Vassily	MALE
Dianne	FEMALE
Ardine	FEMALE
Nicky	MALE
Keith	MALE
Peggy	FEMALE
Candy	FEMALE
Eve	FEMALE
Hayley	FEMALE
Ambros	MALE
Ruth	FEMALE
Gracie	FEMALE
Nanni	FEMALE
Angele	FEMALE
Eulalie	FEMALE
Kelcie	FEMALE
Prasun	MALE
Willy	MALE
Rickey	MALE
Bert	MALE
Arda	FEMALE
Fanechka	FEMALE
Durante	MALE
Hulda	FEMALE
Ulrick	MALE
Fidel	MALE
Winnie	MALE
Garnet	FEMALE
Francine	FEMALE
Jackelyn	FEMALE
Allene	FEMALE
Dehlia	FEMALE
Roze	FEMALE
Tharen	MALE
Porter	MALE
Erich	MALE
Daphene	FEMALE
Geraldine	FEMALE
Susann	FEMALE
Karlyn	FEMALE
Carlos	MALE
Blare	MALE
Trudi	FEMALE
Elke	FEMALE
Logan	MALE
Giffard	MALE
Wynne	FEMALE
Urbanus	MALE
Renelle	FEMALE
Brianne	FEMALE
Faydra	FEMALE
Zenia	FEMALE
Justin	MALE
Sharla	FEMALE
Delphina	FEMALE
Lidia	FEMALE
Elane	FEMALE
Doralynne	FEMALE
Ranique	FEMALE
Tarra	FEMALE
Alister	MALE
Craig	MALE
Cordula	FEMALE
Elenore	FEMALE
Darby	MALE
Sheryl	FEMALE
Chance	MALE
Ferdy	MALE
Wilmer	MALE
Luciano	MALE
Olive	FEMALE
Tome	MALE
Albertina	FEMALE
Rayshell	FEMALE
Nicolea	FEMALE
Ernaline	FEMALE
Ester	FEMALE
Othella	FEMALE
Amargo	FEMALE
Mufi	FEMALE
Verney	MALE
Blondell	FEMALE
Kris	MALE
Ronen	MALE
Odysseus	MALE
Pablo	MALE
Ruby	MALE
Marrilee	FEMALE
Pietro	MALE
Shellie	FEMALE
Keri	FEMALE
Lars	MALE
Kristan	FEMALE
Lisandra	FEMALE
Huntley	MALE
Gussi	FEMALE
Aguinaldo	MALE
Paolina	FEMALE
Sashenka	FEMALE
Bartel	MALE
Patric	MALE
Adolpho	MALE
Sanson	MALE
Josefina	FEMALE
Schuyler	MALE
Edna	FEMALE
Linn	FEMALE
Inessa	FEMALE
Tatiana	FEMALE
Harrison	MALE
Kelli	FEMALE
Marsh	MALE
Gustave	MALE
Barbabra	FEMALE
Gisella	FEMALE
Lamb	FEMALE
Vasili	MALE
Shelley	MALE
Fred	MALE
Dante	MALE
Yard	MALE
Lotte	FEMALE
Jack	MALE
Evette	FEMALE
Shantee	FEMALE
Ariadne	FEMALE
Pooh	MALE
Jenica	FEMALE
Herby	MALE
Uriah	MALE
Jeramie	MALE
Norwood	MALE
Abagael	FEMALE
Wynnie	FEMALE
Axel	MALE
Nannette	FEMALE
Janey	FEMALE
Isidore	MALE
Fowler	MALE
Lionel	MALE
Haskel	MALE
Vinod	MALE
Bailey	MALE
Emanuela	FEMALE
Daryn	FEMALE
Nena	FEMALE
Barbee	FEMALE
Partha	MALE
Raymundo	MALE
Aamir	MALE
Viva	FEMALE
Davis	MALE
Tremain	MALE
Earl	MALE
Francesmary	FEMALE
Waldon	MALE
Dahlia	FEMALE
Maurice	MALE
Morley	MALE
Hermina	FEMALE
Marcel	MALE
Charis	FEMALE
Marcellina	FEMALE
Armstrong	MALE
Bernadette	FEMALE
Melba	FEMALE
Martha	FEMALE
Filmore	MALE
Michell	FEMALE
Ramonda	FEMALE
Corina	FEMALE
Nanci	FEMALE
Janela	FEMALE
Celestyn	FEMALE
Jae	MALE
Mohammad	MALE
Lester	MALE
Jolene	FEMALE
Kacey	FEMALE
Preston	MALE
Jules	MALE
Bealle	MALE
Aloysius	MALE
Doug	MALE
May	FEMALE
Terrance	MALE
Tedda	FEMALE
Patricio	MALE
Olympia	FEMALE
Tedrick	MALE
Dian	FEMALE
Kassia	FEMALE
Retha	FEMALE
Rabbi	MALE
Vikki	FEMALE
Richie	MALE
Erwin	MALE
Gilli	FEMALE
Tremaine	MALE
Helaina	FEMALE
Kimberli	FEMALE
Guthry	MALE
Cathie	FEMALE
Pamelina	FEMALE
Willard	MALE
Jerry	MALE
Liza	FEMALE
Vincent	MALE
Rabi	MALE
Coreen	FEMALE
Lewis	MALE
Kimberlee	FEMALE
Dunc	MALE
Kathi	FEMALE
Vilhelm	MALE
Orsa	FEMALE
Madlen	FEMALE
Nevsa	FEMALE
Jermaine	MALE
Jo-Anne	FEMALE
Homer	MALE
Vernor	MALE
Malina	FEMALE
Rosabel	FEMALE
Nertie	FEMALE
Siward	MALE
Mic	MALE
Abbie	MALE
Ambrosio	MALE
Stephannie	FEMALE
Gusella	FEMALE
Kurtis	MALE
Chrissy	MALE
Collete	FEMALE
Lianna	FEMALE
Vite	MALE
Nitin	FEMALE
Prentice	MALE
Truman	MALE
Verne	MALE
Casia	FEMALE
Rodolphe	MALE
Roman	MALE
Nunzio	MALE
Vania	FEMALE
Malory	FEMALE
Manish	MALE
Nathanial	MALE
Lazare	MALE
Enriqueta	FEMALE
Hilary	MALE
Amalee	FEMALE
Rosemonde	FEMALE
Avrit	FEMALE
Hammad	MALE
Pace	MALE
Liora	FEMALE
Annamaria	FEMALE
Channa	FEMALE
Rod	MALE
Consolata	FEMALE
Elbertina	FEMALE
Alexine	FEMALE
Helsa	FEMALE
Anjela	FEMALE
Heinrich	MALE
Henryetta	FEMALE
Lauralee	FEMALE
Orlando	MALE
Noe	MALE
Cassey	FEMALE
Raphaela	FEMALE
Isabeau	FEMALE
Conny	FEMALE
Drew	MALE
Eugene	MALE
Maury	MALE
Esme	MALE
Karleen	FEMALE
Beale	MALE
Doe	FEMALE
Meryl	MALE
Maybelle	FEMALE
Weidar	MALE
Ebony	FEMALE
Penelope	FEMALE
Hiram	MALE
Alice	FEMALE
Betti	FEMALE
Prudi	FEMALE
Graham	MALE
Hollis	MALE
Britney	FEMALE
Marten	MALE
Celestina	FEMALE
Pete	MALE
Ladonna	FEMALE
Luana	FEMALE
Roslyn	FEMALE
Danit	FEMALE
Lavinia	FEMALE
Erastus	MALE
Loralee	FEMALE
Bettina	FEMALE
Noam	MALE
Silvanus	MALE
Xavier	MALE
Hudson	MALE
Mikey	MALE
Cicely	FEMALE
Terri-Jo	FEMALE
Sharai	FEMALE
Janis	FEMALE
Zea	FEMALE
Kessiah	FEMALE
Julita	FEMALE
Dexter	MALE
Rolando	MALE
Hamid	MALE
Thom	MALE
Douggie	MALE
Trisha	FEMALE
Sylvester	MALE
Avrom	MALE
Francoise	FEMALE
Lucio	MALE
Paolo	MALE
Piggy	MALE
Harrie	FEMALE
Ashlee	FEMALE
Catharina	FEMALE
Melantha	FEMALE
Corabella	FEMALE
Loella	FEMALE
Geraldina	FEMALE
Gardner	MALE
Alyda	FEMALE
Reagan	MALE
Oscar	MALE
Ellie	FEMALE
Winni	FEMALE
Dael	FEMALE
Delmar	MALE
Aurlie	FEMALE
Wittie	MALE
Sylvan	MALE
Evangelina	FEMALE
Jeannine	FEMALE
Malinda	FEMALE
Asia	FEMALE
Ulrich	MALE
Dorthea	FEMALE
Theressa	FEMALE
Aubrey	MALE
Adriane	FEMALE
Lance	MALE
Vincents	MALE
Benny	MALE
Molly	FEMALE
Veronique	FEMALE
Klara	FEMALE
Johnny	MALE
Elwood	MALE
Carrol	FEMALE
Luigi	MALE
Klarrisa	FEMALE
Cameo	FEMALE
Muriel	FEMALE
Phebe	FEMALE
Stephan	MALE
Harmonia	FEMALE
Sherlock	MALE
Taylor	MALE
Sherwynd	MALE
Nadine	FEMALE
Leigh	MALE
Kessia	FEMALE
Shawnee	FEMALE
Daile	FEMALE
Ottilie	FEMALE
Tab	MALE
Enya	FEMALE
Carma	FEMALE
Nikoletta	FEMALE
Gianina	FEMALE
Monique	FEMALE
Franky	MALE
Cathe	FEMALE
Whittaker	MALE
Carine	FEMALE
Rachael	FEMALE
Nonie	FEMALE
Ashlen	FEMALE
Morgana	FEMALE
Dulcia	FEMALE
Darwin	MALE
Mureil	FEMALE
Stanislaw	MALE
Karilynn	FEMALE
Clayborn	MALE
Andie	MALE
Cristopher	MALE
Brittan	FEMALE
Jerrome	MALE
Sebastiano	MALE
Gayleen	FEMALE
Salvatore	MALE
Tad	MALE
Lemmie	MALE
Hiro	MALE
Thomas	MALE
Hugh	MALE
Eustace	MALE
Georgia	MALE
Gustavus	MALE
Melanie	FEMALE
Nikolai	MALE
Madeline	FEMALE
Kristi	FEMALE
Elberta	FEMALE
Naoma	FEMALE
Linea	FEMALE
Eric	MALE
Jeri	FEMALE
Laird	MALE
Clemmy	FEMALE
Cody	MALE
Luella	FEMALE
Hakim	MALE
Karee	FEMALE
Fazeel	MALE
Oral	MALE
Viv	FEMALE
Claudie	FEMALE
Jessy	FEMALE
Ramon	MALE
Forester	MALE
Fiann	FEMALE
Atlanta	FEMALE
Kenn	MALE
Aziz	MALE
Zarah	FEMALE
Regan	MALE
Maddalena	FEMALE
Adolf	MALE
Mervin	MALE
Steward	MALE
Joscelin	FEMALE
Barrie	MALE
Kirstin	FEMALE
Rodrigo	MALE
Gena	FEMALE
Gabriela	FEMALE
Brynna	FEMALE
Clancy	MALE
Ophelia	FEMALE
Gordon	MALE
Shoshanna	FEMALE
Patrik	MALE
Joceline	FEMALE
Tabbitha	FEMALE
Filbert	MALE
Torrence	MALE
Aimee	FEMALE
Milena	FEMALE
Dori	FEMALE
Kala	FEMALE
Kit	MALE
Olag	MALE
Tish	FEMALE
Bellanca	FEMALE
Bo	MALE
Kane	MALE
Lindsy	FEMALE
Sherwood	MALE
Othilia	FEMALE
Angelia	FEMALE
Konstantin	MALE
Clinton	MALE
Jerzy	MALE
Austen	MALE
Gladi	FEMALE
Clementine	FEMALE
Kesley	FEMALE
Matilda	FEMALE
Olympie	FEMALE
Salomon	MALE
Tedman	MALE
Charlot	FEMALE
Dasi	FEMALE
Davidde	MALE
Juanita	MALE
Sascha	MALE
Ame	FEMALE
Aimil	FEMALE
Kaleb	MALE
Edmond	MALE
Dawson	MALE
Halvard	MALE
Engracia	FEMALE
Katalin	FEMALE
Alta	FEMALE
Pieter	MALE
Giuseppe	MALE
Ezekiel	MALE
Paul	MALE
Sallyann	FEMALE
Floris	FEMALE
Kiele	FEMALE
Bunnie	FEMALE
Enrico	MALE
Nerissa	FEMALE
Jillana	FEMALE
Cherianne	FEMALE
Ephraim	MALE
Olympe	FEMALE
Tammara	FEMALE
Niven	MALE
Tomiko	FEMALE
Udell	MALE
Melli	FEMALE
Tedie	MALE
Danette	FEMALE
Willis	MALE
Micheil	MALE
Sturgis	MALE
Christine	FEMALE
Gabie	FEMALE
Nicolle	FEMALE
Catherine	FEMALE
Bing	MALE
Willow	FEMALE
Kristopher	MALE
Gretal	FEMALE
Lorain	FEMALE
Mace	MALE
Matthew	MALE
Carmen	FEMALE
Henry	MALE
Ty	MALE
Justis	MALE
Peyton	MALE
Lemmy	MALE
Hussein	MALE
Kirbie	FEMALE
Sarge	MALE
Hercules	MALE
Derrek	MALE
Lynnette	FEMALE
Chelsae	FEMALE
Karylin	FEMALE
Stewart	MALE
Lazarus	MALE
Belle	FEMALE
Adi	FEMALE
Merv	MALE
Harris	MALE
Margi	FEMALE
Baldwin	MALE
Carlynn	FEMALE
Annmaria	FEMALE
Katlin	FEMALE
Norton	MALE
Jeraldine	FEMALE
Jorrie	FEMALE
Heath	MALE
Brooke	MALE
Lorna	FEMALE
Bernelle	FEMALE
Irving	MALE
Benn	MALE
Pinchas	MALE
Dirk	MALE
Elysia	FEMALE
Ambrose	MALE
Mohamad	MALE
Griffin	MALE
Marla	FEMALE
Pascal	MALE
Merola	FEMALE
Whitney	MALE
Susana	FEMALE
Rick	MALE
Frederich	MALE
Nata	FEMALE
Barbi	FEMALE
Kira	FEMALE
Kimberly	FEMALE
Stig	MALE
Letty	FEMALE
Jotham	MALE
Corky	MALE
Stevy	MALE
Augusto	MALE
Theophyllus	MALE
Hanford	MALE
Kylynn	FEMALE
Keely	FEMALE
Andy	MALE
Teressa	FEMALE
Baillie	MALE
Trix	FEMALE
Adolfo	MALE
Isadora	FEMALE
Olly	FEMALE
Thorsten	MALE
Harlie	FEMALE
Julia	FEMALE
Allin	MALE
Audy	FEMALE
Barbaraanne	FEMALE
Martina	FEMALE
Murdock	MALE
Barr	MALE
Emeline	FEMALE
Charmion	FEMALE
Ninetta	FEMALE
Marta	FEMALE
Lorilee	FEMALE
Ruthann	FEMALE
Joe	MALE
Carson	MALE
Flynn	MALE
Dasya	FEMALE
Joni	FEMALE
Maggy	FEMALE
Grove	MALE
Celle	FEMALE
Langston	MALE
Cain	MALE
Bary	MALE
Prudence	FEMALE
Tonie	FEMALE
Kally	FEMALE
Karlie	FEMALE
Wilden	MALE
Wes	MALE
Shel	FEMALE
Guillermo	MALE
Nickie	MALE
Lawerence	MALE
Carlyn	FEMALE
Richmond	MALE
Karina	FEMALE
Allison	FEMALE
Bishop	MALE
Kandace	FEMALE
Tiffanie	FEMALE
Fox	MALE
Enrichetta	FEMALE
Karlee	FEMALE
Leese	FEMALE
Maggi	FEMALE
Ginevra	FEMALE
Rowland	MALE
Julietta	FEMALE
Gilly	FEMALE
Adrick	MALE
Josefa	FEMALE
Lyndon	MALE
Pail	MALE
Mauricio	MALE
Salomo	MALE
Traver	MALE
Shorty	MALE
Susette	FEMALE
Ingram	MALE
Dyna	FEMALE
Montague	MALE
Sheena	FEMALE
Renee	FEMALE
Paton	MALE
Georg	MALE
Bradford	MALE
Haskell	MALE
Kare	FEMALE
Aubert	MALE
Tilda	FEMALE
Teodoro	MALE
Sky	MALE
Irwin	MALE
Robina	FEMALE
Illa	FEMALE
Gershon	MALE
Melly	FEMALE
Dwane	MALE
Clarey	FEMALE
Shina	FEMALE
Levy	MALE
Sharona	FEMALE
Everard	MALE
Susy	FEMALE
Tynan	MALE
Corly	FEMALE
Kirsteni	FEMALE
Sofie	FEMALE
Renaldo	MALE
Myrle	FEMALE
Godwin	MALE
Jordy	MALE
Rasla	FEMALE
Gwendolin	FEMALE
Elvis	MALE
Barnabas	MALE
Flem	MALE
Rori	FEMALE
Carlyle	MALE
Aditya	MALE
Margit	FEMALE
Bridgette	FEMALE
Danyelle	FEMALE
Westbrooke	MALE
Modestia	FEMALE
Ulrica	FEMALE
Peter	MALE
Sarah	FEMALE
Petronella	FEMALE
Gweneth	FEMALE
Tom	MALE
Theresina	FEMALE
Valencia	FEMALE
Napoleon	MALE
Raine	FEMALE
Janina	FEMALE
Hodge	MALE
Norris	MALE
Albatros	MALE
Kimball	MALE
Barbara-Anne	FEMALE
Star	FEMALE
Irita	FEMALE
Gale	MALE
Hilde	FEMALE
Towney	MALE
Richy	MALE
Rudy	MALE
Phillip	MALE
Ethan	MALE
Faina	FEMALE
Ira	MALE
Syd	MALE
Darcey	FEMALE
Georgy	MALE
Mohammed	MALE
Harland	MALE
Rosella	FEMALE
Gay	MALE
Whitman	MALE
Lorne	MALE
Bobine	FEMALE
Aguste	MALE
Rena	FEMALE
Dawn	FEMALE
Leanna	FEMALE
Sayres	MALE
Gene	MALE
Liz	FEMALE
Dyana	FEMALE
Shaw	MALE
Codie	FEMALE
Nathanael	MALE
Sena	FEMALE
Ham	MALE
Caryl	MALE
Fredericka	FEMALE
Skelly	MALE
Tillie	FEMALE
Jazmin	FEMALE
Rochelle	FEMALE
Webb	MALE
Gary	MALE
Phedra	FEMALE
Tarah	FEMALE
Chancey	MALE
Riley	MALE
Pietra	FEMALE
Perrine	FEMALE
Sheff	MALE
Tobiah	MALE
Carissa	FEMALE
Cornellis	MALE
Roxanne	FEMALE
Quentin	MALE
Moe	MALE
Eddy	MALE
Inci	FEMALE
Thaine	MALE
Chloette	FEMALE
Martynne	FEMALE
Walter	MALE
Yance	MALE
Wait	MALE
Jocelin	FEMALE
Desmund	MALE
Francisco	MALE
Smitty	MALE
Maddie	MALE
Lyndell	FEMALE
Ivett	FEMALE
Marian	FEMALE
Sibel	FEMALE
Hobart	MALE
Angil	FEMALE
Katerine	FEMALE
Mildrid	FEMALE
Stesha	FEMALE
Ephram	MALE
Yancy	MALE
Althea	FEMALE
Chris	MALE
Putnam	MALE
Ardyth	FEMALE
Bengt	MALE
Elvira	FEMALE
Lanna	FEMALE
Bel	FEMALE
Jeff	MALE
Hedda	FEMALE
Heddie	FEMALE
Myrta	FEMALE
Mackenzie	MALE
Annalise	FEMALE
Ebeneser	MALE
Annalyse	FEMALE
Jeanne	FEMALE
Florenza	FEMALE
Dynah	FEMALE
Michel	MALE
Filip	MALE
Ambrosia	FEMALE
Timothea	FEMALE
Dabney	MALE
Hali	FEMALE
Glynnis	FEMALE
Candida	FEMALE
Jodee	FEMALE
Theodoric	MALE
Obie	MALE
Kermie	MALE
Albert	MALE
Ina	FEMALE
Suzi	FEMALE
Carlton	MALE
Carilyn	FEMALE
Shamus	MALE
Karin	FEMALE
Jami	FEMALE
Kaye	FEMALE
Oren	MALE
Toni	FEMALE
Emmett	MALE
Morly	MALE
Anabella	FEMALE
Daryl	MALE
Selma	FEMALE
Raina	FEMALE
Karia	FEMALE
Buddy	MALE
Ely	MALE
Giovanna	FEMALE
Wesley	MALE
Ursulina	FEMALE
Louisa	FEMALE
Lillis	FEMALE
Ajai	MALE
Pavia	FEMALE
Hedi	FEMALE
Dorena	FEMALE
Torin	MALE
Bonni	FEMALE
Otha	FEMALE
Stearne	MALE
Josephina	FEMALE
Thad	MALE
Geoff	MALE
Jojo	FEMALE
Shelbi	FEMALE
Tamarra	FEMALE
Sandye	FEMALE
Concordia	FEMALE
Ossie	MALE
Ransell	MALE
Rahul	MALE
Hilliary	FEMALE
Alia	FEMALE
Mala	FEMALE
Thorstein	MALE
Walt	MALE
Ambrosi	MALE
Mirabel	FEMALE
Monte	MALE
Modestine	FEMALE
