Прокопий	MALE
Галя	FEMALE
Катя	FEMALE
Раиса	FEMALE
Марат	MALE
Парфений	MALE
Изабелла	FEMALE
Анжела	FEMALE
Леонтий	MALE
Мирослава	FEMALE
Федосья	FEMALE
Илья	MALE
Аркадий	MALE
Лиза	FEMALE
Анастасия	FEMALE
Лена	FEMALE
Еремей	MALE
Доминика	FEMALE
Галина	FEMALE
Эльвира	FEMALE
Илларион	MALE
Ириней	MALE
Валерьян	MALE
Зоя	FEMALE
Фёкла	FEMALE
Борис	MALE
Лариса	FEMALE
Володя	MALE
Глеб	MALE
Женя	MALE
Дана	FEMALE
Всеволод	MALE
Евпраксия	FEMALE
Дина	FEMALE
Людмила	FEMALE
Руслан	MALE
Нелли	FEMALE
Лука	MALE
Богдан	MALE
Прохор	MALE
Евфросиния	FEMALE
Никита	MALE
Пантелеймон	MALE
Феврония	FEMALE
Александра	FEMALE
Игнат	MALE
Роберт	MALE
Фома	MALE
Евгения	FEMALE
Яков	MALE
Валерий	MALE
Иакинф	MALE
Инна	FEMALE
Елизавета	FEMALE
Нюша	FEMALE
Злата	FEMALE
Вячеслав	MALE
Стася	FEMALE
Яна	FEMALE
Алёна	FEMALE
Рената	FEMALE
Мальвина	FEMALE
Виктория	FEMALE
Варвара	FEMALE
Кузьма	MALE
Евграф	MALE
Венедикт	MALE
Прасковья	FEMALE
Фаина	FEMALE
Гриша	MALE
Аристарх	MALE
Эмма	FEMALE
Юлия	FEMALE
Митрофан	MALE
Игорь	MALE
Захар	MALE
Евгений	MALE
Ким	MALE
Игнатий	MALE
Роман	MALE
Ярослава	FEMALE
Юра	MALE
Татьяна	FEMALE
Владлен	MALE
Лукьян	MALE
Агафья	FEMALE
Вероника	FEMALE
Егор	MALE
Поля	FEMALE
Герман	MALE
Юрий	MALE
Тимур	MALE
Георгий	MALE
Авксентий	MALE
Касьян	MALE
Авдей	MALE
Мария	FEMALE
Миша	MALE
Вася	MALE
Кондрат	MALE
Инесса	FEMALE
Варлам	MALE
Давид	MALE
Марина	FEMALE
Антонина	FEMALE
Оля	FEMALE
Денис	MALE
Михаил	MALE
Геннадий	MALE
Фаддей	MALE
Трифон	MALE
Алексей	MALE
Розалина	FEMALE
Лера	FEMALE
Снежана	FEMALE
Максим	MALE
Владимир	MALE
Исидор	MALE
Павел	MALE
Оксана	FEMALE
Альбина	FEMALE
Афанасий	MALE
Акулина	FEMALE
Иулиан	MALE
Степан	MALE
Ростислав	MALE
Алиса	FEMALE
Вадим	MALE
Альвиан	MALE
Антон	MALE
Анжелика	FEMALE
Аня	FEMALE
Любовь	FEMALE
Дашa	FEMALE
Юлиан	MALE
Таисия	FEMALE
Лина	FEMALE
Полина	FEMALE
Жора	MALE
Христофор	MALE
Гена	MALE
Каролина	FEMALE
Андрей	MALE
Антонин	MALE
Федосей	MALE
Наина	FEMALE
Регина	FEMALE
Лидия	FEMALE
Витя	MALE
Мартын	MALE
Пелагея	FEMALE
Пётр	MALE
Маргарита	FEMALE
Станислав	MALE
Мэлор	MALE
Дарья	FEMALE
Арсений	MALE
Глафира	FEMALE
Владислав	MALE
Валентин	MALE
Артём	MALE
Майя	FEMALE
Иванна	FEMALE
Ангелина	FEMALE
Матрёна	FEMALE
Марфа	FEMALE
Вера	FEMALE
Юстин	MALE
Созон	MALE
Лёня	MALE
Дорофей	MALE
Протасий	MALE
Инга	FEMALE
Герасим	MALE
Толя	MALE
Куприян	MALE
Люба	FEMALE
Геласий	MALE
Дмитрий	MALE
Родион	MALE
Анфиса	FEMALE
Анна	FEMALE
Василий	MALE
Капитолина	FEMALE
Василиса	FEMALE
Валерия	FEMALE
Лукий	MALE
Олег	MALE
Ия	FEMALE
Филат	MALE
Спартак	MALE
Диана	FEMALE
Дима	MALE
Мелентий	MALE
Искра	FEMALE
Демьян	MALE
Ульяна	FEMALE
Сергей	MALE
Владлена	FEMALE
Карина	FEMALE
Эдуард	MALE
Эраст	MALE
Слава	MALE
Федот	MALE
Кирилл	MALE
Валентина	FEMALE
Светлана	FEMALE
Лада	FEMALE
Макар	MALE
Стёпа	MALE
Разумник	MALE
Октябрина	FEMALE
Ермиония	FEMALE
Екатерина	FEMALE
Вениамин	MALE
Аристион	MALE
Серёжа	MALE
Алевтина	FEMALE
Влад	MALE
Константин	MALE
Нестор	MALE
Альберт	MALE
София	FEMALE
Ника	FEMALE
Надежда	FEMALE
